a - indefinite article - [ə] - невизначений артикль - A1
abandon - v. - [əˈbændən] - покидати - B2
ability - n. - [əˈbɪləti] - здатність - A2
able - adj. - [ˈeɪbəl] - здатний - A2
about - prep., adv. - [əˈbaʊt] - про, близько - A1
above - prep., adv. - [əˈbʌv] - над, вище - A1
abroad - adv. - [əˈbrɔːd] - за кордоном - A2
absolute - adj. - [ˈæbsəluːt] - абсолютний - B2
absolutely - adv. - [ˈæbsəluːtli] - абсолютно - B1
academic - adj., n. - [ˌækəˈdemɪk] - академічний, учений - B1, B2
accept - v. - [əkˈsɛpt] - приймати - A2
acceptable - adj. - [əkˈsɛptəbl] - прийнятний - B2
access - n., v. - [ˈækˌsɛs] - доступ, мати доступ - B1
accident - n. - [ˈæk.sɪ.dənt] - нещасний випадок - A2
accommodation - n. - [əˌkɒm.əˈdeɪ.ʃən] - проживання - B1
accompany - v. - [əˈkʌmpəni] - супроводжувати - B2
according to - prep. - [əˈkɔrdɪŋ tu] - згідно з - A2
account - n., v. - [əˈkaʊnt] - рахунок, обліковий запис - B1, B2
accurate - adj. - [ˈækjərət] - точний - B2
accuse - v. - [əˈkjuːz] - звинувачувати - B2
achieve - v. - [əˈtʃiːv] - досягати - A2
achievement - n. - [əˈtʃiːvmənt] - досягнення - B1
acknowledge - v. - [əkˈnɒlɪdʒ] - визнавати - B2
acquire - v. - [əˈkwaɪə] - набувати - B2
across - prep., adv. - [əˈkrɒs] - через, наперекір - A1
act - v. - [ækt], n. - [ækt] - дія, діяти - A2, B1
action - n. - [ˈækʃən] - дія, діяльність - A1
active - adj. - [ˈæktɪv] - активний - A2
activity - n. - [ækˈtɪvəti] - діяльність - A1
actor - n. - [ˈæktər] - актор - A1
actress - n. - [ˈæktrɪs] - акторка - A1
actual - adj. - [ˈæktʃuəl] - фактичний - B2
actually - adv. - [ˈæktʃuəli] - фактично - A2
ad - n. - [æd] - оголошення - B1
adapt - v. - [əˈdæpt] - адаптувати - B2
add - v. - [æd] - додавати - A1
addition - n. - [əˈdɪʃən] - додавання - B1
additional - adj. - [əˈdɪʃənl] - додатковий - B2
address - n. - [əˈdrɛs], v. - [əˈdrɛs] - адреса, звертатися - A1, B2
administration - n. - [ədˌmɪnɪˈstreɪʃən] - управління - B2
admire - v. - [ədˈmaɪər] - захоплюватися - B1
admit - v. - [ədˈmɪt] - визнавати - B1
adopt - v. - [əˈdɒpt] - усиновлювати, приймати - B2
adult - n. - [ˈædʌlt], adj. - [əˈdʌlt] - дорослий - A1, A2
advance - n., v., adj. - [ədˈvæns] - просування, просуватися, передовий - B2
advanced - adj. - [ædˈvænst] - високорозвинений - B1
advantage - n. - [ədˈvæntɪdʒ] - перевага - A2
adventure - n. - [ədˈvɛnʧər] - пригода - A2
advertise - v. - [ˈædvərtaɪz] - рекламувати - A2
advertisement - n. - [ədˈvɜrtɪsmənt] - реклама - A2
advertising - n. - [ˈædvərtaɪzɪŋ] - реклама - A2
advice - n. - [ədˈvaɪs] - порада - A1
advise - v. - [ədˈvaɪz] - радити - B1
affair - n. - [əˈfɛr] - справа, роман - B2
affect - v. - [əˈfɛkt] - впливати - A2
afford - v. - [əˈfɔrd] - мати можливість, дозволити собі - B1
afraid - adj. - [əˈfreɪd] - боязкий - A1
after - prep. - [ˈæftər], conj., adv. - [ˈæftər] - після, після того як - A1, A2
afternoon - n. - [ˌæftərˈnuːn] - післяполуденок - A1
afterwards - adv. - [ˌæftərˈwɜrdz] - після цього, потім - B2
again - adv. - [əˈɡɛn] - знову - A1
against - prep. - [əˈɡɛnst] - проти - A2
age - n. - [eɪdʒ], v. - [eɪdʒ] - вік, старіти - A1, B1
aged - adj. - [eɪdʒd] - постарілий - B1
agency - n. - [ˈeɪdʒənsɪ] - агентство - B2
agenda - n. - [əˈdʒɛndə] - порядок денний - B2
agent - n. - [ˈeɪdʒənt] - агент - B1
aggressive - adj. - [əˈɡrɛsɪv] - агресивний - B2
ago - adv. - [əˈɡoʊ] - тому - A1
agree - v. - [əˈɡri] - погоджуватися - A1
agreement - n. - [əˈɡriːmənt] - угода - B1
ah - exclam. - [ɑː] - ах - A2
ahead - adv. - [əˈhɛd] - попереду - B1
aid - n., v. - [eɪd] - допомога, допомагати - B2
aim - v., n. - [eɪm] - мета, мірити - B1
air - n. - [ɛr] - повітря - A1
aircraft - n. - [ˈɛrˌkræft] - літак - B2
airline - n. - [ˈɛrˌlaɪn] - авіакомпанія - A2
airport - n. - [ˈɛrˌpɔrt] - аеропорт - A1
alarm - n. - [əˈlɑrm], v. - [əˈlɑrm] - сигнал тривоги, попереджати - B1, B2
album - n. - [ˈælbəm] - альбом - B1
alcohol - n. - [ˈælkəhɔl] - алкоголь - B1
alcoholic - adj. - [ˌælkəˈhɒlɪk] - алкогольний - B1
alive - adj. - [əˈlaɪv] - живий - A2
all - det., pron. - [ɔːl], adv. - [ɔːl] - всі - A1, A2
all right - adj./adv., exclam. - [ɔːl raɪt] - все в порядку - A2
allow - v. - [əˈlaʊ] - дозволяти - A2
almost - adv. - [ˈɔːlmoʊst] - майже - A2
alone - adj./adv. - [əˈloʊn] - самотній, сам - A2
along - prep., adv. - [əˈlɔŋ] - вздовж, по - A2
already - adv. - [ɔːlˈrɛdi] - вже - A2
also - adv. - [ˈɔːlsoʊ] - також - A1
alter - v. - [ˈɔːltər] - змінювати - B2
alternative - n. - [ɔːlˈtɜrnətɪv], adj. - [ɔːlˈtɜrnətɪv] - альтернатива, альтернативний - A2, B1
although - conj. - [ɔːlˈðoʊ] - хоча - A2
always - adv. - [ˈɔːlweɪz] - завжди - A1
amazed - adj. - [əˈmeɪzd] - вражений - B1
amazing - adj. - [əˈmeɪzɪŋ] - дивовижний - A1
ambition - n. - [æmˈbɪʃən] - амбіція - B1
ambitious - adj. - [æmˈbɪʃəs] - амбіційний - B1
among - prep. - [əˈmʌŋ] - серед - A2
amount - n. - [əˈmaʊnt], v. - [əˈmaʊnt] - кількість, дорівнювати - A2, B2
analyse - v. - [ˈænəˌlaɪz] - аналізувати - B1
analysis - n. - [əˈnæləsɪs] - аналіз - B1
ancient - adj. - [ˈeɪnʃənt] - стародавній - A2
and - conj. - [ænd] - і - A1
anger - n. - [ˈæŋɡər] - гнів - B2
angle - n. - [ˈæŋɡəl] - кут - B2
angry - adj. - [ˈæŋɡri] - сердитий - A1
animal - n. - [ˈænɪməl] - тварина - A1
ankle - n. - [ˈæŋkl̩] - лодижка - A2
anniversary - n. - [ˌænɪˈvɜrsəri] - річниця - B2
announce - v. - [əˈnaʊns] - оголошувати - B1
announcement - n. - [əˈnaʊnsmənt] - оголошення - B1
annoy - v. - [əˈnɔɪ] - дратувати - B1
annoyed - adj. - [əˈnɔɪd] - обурений - B1
annoying - adj. - [əˈnɔɪɪŋ] - дратівливий - B1
annual - adj. - [ˈænjuəl] - щорічний - B2
another - det./pron. - [əˈnʌðər] - інший - A1
answer - n., v. - [ˈænsər] - відповідь, відповідати - A1
anxious - adj. - [ˈæŋkʃəs] - стурбований, нетерплячий - B2
any - det., pron. - [ˈɛni], adv. - [ˈɛni] - будь-який - A1, A2
anybody - pron. - [ˈɛnibɒdi] - хто-небудь - A2
any more - adv. - [ˌɛni ˈmɔːr] - більше не - A2
anyone - pron. - [ˈɛniwʌn] - будь-хто - A1
anything - pron. - [ˈɛnɪˌθɪŋ] - що-небудь - A1
anyway - adv. - [ˈɛniˌweɪ] - так чи інакше - A2
anywhere - adv., pron. - [ˈɛniˌwɛr] - будь-де - A2
apart - adv. - [əˈpɑrt] - окремо - B1
apartment - n. - [əˈpɑrtmənt] - квартира - A1
apologize - v. - [əˈpɒləˌdʒaɪz] - вибачатися - B1
app - n. - [æp] - додаток - A2
apparent - adj. - [əˈpærənt] - очевидний - B2
apparently - adv. - [əˈpærəntli] - очевидно - B2
appeal - n., v. - [əˈpil] - апеляція, звертатися - B2
appear - v. - [əˈpɪr] - здаватися, з'являтися - A2
appearance - n. - [əˈpɪrəns] - зовнішність - A2
apple - n. - [ˈæpl̩] - яблуко - A1
application - n. - [ˌæplɪˈkeɪʃən] - заява, звернення - B1
apply - v. - [əˈplaɪ] - застосовувати, подавати заяву - A2
appointment - n. - [əˈpɔɪntmənt] - призначення, зустріч - B1
appreciate - v. - [əˈpriʃieɪt] - цінувати, оцінювати - B1
approach - n., v. - [əˈproʊtʃ] - підхід, підходити - B2
appropriate - adj. - [əˈproʊpriət] - відповідний - B2
approval - n. - [əˈpruvəl] - затвердження - B2
approve - v. - [əˈpruv] - затверджувати - B2
approximately - adv. - [əˈprɑksɪmətli] - приблизно - B1
April - n. - [ˈeɪprəl] - квітень - A1
architect - n. - [ˈɑrkɪtɛkt] - архітектор - A2
architecture - n. - [ˈɑrkɪtɛktʃər] - архітектура - A2
area - n. - [ˈɛriə] - область - A1
argue - v. - [ˈɑrgju] - сперечатися - A2
argument - n. - [ˈɑrgjəmənt] - аргумент, сперечання - A2
arise - v. - [əˈraɪz] - виникати - B2
arm - n. - [ɑrm] - рука - A1
armed - adj. - [ɑrmd] - озброєний - B2
arms - n. - [ɑrmz] - зброя - B2
army - n. - [ˈɑrmi] - армія - A2
around - prep., adv. - [əˈraʊnd] - навколо - A1
arrange - v. - [əˈreɪndʒ] - організовувати, домовлятися - A2
arrangement - n. - [əˈreɪndʒmənt] - узгодження, домовленість - A2
arrest - v., n. - [əˈrɛst] - затримувати, арешт - B1
arrival - n. - [əˈraɪvəl] - прибуття - B1
arrive - v. - [əˈraɪv] - прибувати - A1
art - n. - [ɑrt] - мистецтво - A1
article - n. - [ˈɑrtɪkl̩] - стаття - A1
artificial - adj. - [ˌɑrtɪˈfɪʃəl] - штучний - B2
artist - n. - [ˈɑrtɪst] - художник - A1
artistic - adj. - [ɑrˈtɪstɪk] - художній - B2
as - prep. - [æz], adv., conj. - [æz] - як, коли, так як - A1, A2
ashamed - adj. - [əˈʃeɪmd] - соромитися - B2
ask - v. - [æsk] - питати - A1
asleep - adj. - [əˈsliːp] - сплячий - A2
aspect - n. - [ˈæspɛkt] - аспект - B2
assess - v. - [əˈsɛs] - оцінювати - B2
assessment - n. - [əˈsɛsmənt] - оцінка - B2
assignment - n. - [əˈsaɪnmənt] - завдання - B1
assist - v. - [əˈsɪst] - допомагати - B1
assistant - n., adj. - [əˈsɪstənt] - помічник - A2
associate - v. - [əˈsoʊsieɪt] - асоціювати, пов'язувати - B2
associated - adj. - [əˈsoʊsieɪtəd] - пов'язаний - B2
association - n. - [əˌsoʊsiˈeɪʃən] - асоціація - B2
assume - v. - [əˈsum] - припускати, вважати - B2
at - prep. - [æt] - при, на - A1
athlete - n. - [ˈæθlit] - спортсмен - A2
atmosphere - n. - [ˈætməsfɪr] - атмосфера - B1
attach - v. - [əˈtæʧ] - прикріплювати - B1
attack - n., v. - [əˈtæk] - напад, нападати - A2
attempt - n., v. - [əˈtɛmpt] - спроба, намагатися - B2
attend - v. - [əˈtɛnd] - відвідувати - A2
attention - n., exclam. - [əˈtɛnʃən] - увага - A2
attitude - n. - [ˈætɪˌtud] - ставлення - B1
attract - v. - [əˈtrækt] - привертати - B1
attraction - n. - [əˈtrækʃən] - привабливість - B1
attractive - adj. - [əˈtræktɪv] - привабливий - A2
audience - n. - [ˈɔdiəns] - аудиторія - A2
August - n. - [ɔːˈɡʌst] - серпень - A1
aunt - n. - [ænt] - тітка - A1
author - n. - [ˈɔːθər] - автор - A2
authority - n. - [ɔːˈθɒrəti] - влада - B1
autumn - n. - [ˈɔtəm] - осінь - A1
available - adj. - [əˈveɪləbl̩] - доступний - A2
average - adj., n. - [ˈævərɪdʒ], v. - [ˈævərɪdʒ] - середній, середнє значення - A2, B1
avoid - v. - [əˈvɔɪd] - уникати - A2
award - n. - [əˈwɔrd], v. - [əˈwɔrd] - нагорода, вручити нагороду - A2, B1
aware - adj. - [əˈwɛr] - усвідомлений - B1
away - adv. - [əˈweɪ] - далеко, відсутній - A1
awful - adj. - [ˈɔfl̩] - жахливий - A2
baby - n. - [ˈbeɪbi] - дитина - A1
back - n., adv. - [bæk], adj. - [bæk], v. - [bæk] - спина, назад, задній, повертати - A1, A2, B2
background - n. - [ˈbækɡraʊnd] - фон - A2
backwards - adv. - [ˈbækwərdz] - назад - B1
bacteria - n. - [bækˈtɪriə] - бактерії - B2
bad - adj. - [bæd] - поганий - A1
badly - adv. - [ˈbædli] - погано - A2
bag - n. - [bæɡ] - сумка - A1
bake - v. - [beɪk] - пекти - B1
balance - n., v. - [ˈbæləns], [ˈbæləns] - баланс, урівноважувати - B1
ball - n. - [bɔl] - м'яч - A1
ban - v., n. - [bæn] - забороняти, заборона - B1
banana - n. - [bəˈnænə] - банан - A1
band - n. - [bænd] - група, бандаж - A1
bank (money) - n. - [bæŋk] - банк - A1
bank (river) - n. - [bæŋk] - берег - B1
bar - n. - [bɑr], v. - [bɑr] - бар, блокувати - A2, B2
barrier - n. - [ˈbæriər] - бар'єр - B2
base - n., v. - [beɪs], [beɪs] - база, базувати - B1
baseball - n. - [ˈbeɪsˌbɔl] - бейсбол - A2
based - adj. - [beɪst] - базовий - A2
basic - adj. - [ˈbeɪsɪk] - основний - B1
basically - adv. - [ˈbeɪsɪkli] - в основному - B2
basis - n. - [ˈbeɪsɪs] - основа - B1
basketball - n. - [ˈbæsˌkɛtˌbɔl] - баскетбол - A2
bath - n. - [bæθ] - ванна - A1
bathroom - n. - [ˈbæθˌruːm] - ванна кімната - A1
battery - n. - [ˈbætəri] - акумулятор - B1
battle - n., v. - [ˈbætl̩], [ˈbætl̩] - битва, боротися - B1, B2
be - v., auxiliary v. - [bi] - бути - A1
beach - n. - [biːʧ] - пляж - A1
bean - n. - [biːn] - квасоля - A2
bear (deal with) - v. - [bɛr] - терпіти, витримувати - B2
bear (animal) - n. - [bɛr] - ведмідь - A2
beat - v. - [bit], n. - [bit] - перемагати, удар - A2, B2
beautiful - adj. - [ˈbjuːtɪfəl] - красивий - A1
beauty - n. - [ˈbjuːti] - краса - B1
because - conj. - [bɪˈkɔz] - тому що - A1
become - v. - [bɪˈkʌm] - ставати - A1
bed - n. - [bɛd] - ліжко - A1
bedroom - n. - [ˈbɛdˌrum] - спальня - A1
bee - n. - [bi] - бджола - B1
beef - n. - [biːf] - яловичина - A2
beer - n. - [bɪr] - пиво - A1
before - prep. - [bɪˈfɔr], conj., adv. - [bɪˈfɔr] - перед, перед тим як - A1, A2
beg - v. - [bɛɡ] - благати - B2
begin - v. - [bɪˈɡɪn] - починати - A1
beginning - n. - [bɪˈɡɪnɪŋ] - початок - A1
behave - v. - [bɪˈheɪv] - вести себе - A2
behaviour - n. - [bɪˈheɪvjər] - поведінка - A2
behind - prep., adv. - [bɪˈhaɪnd] - за, позаду - A1
being - n. - [ˈbiɪŋ] - існування - B2
belief - n. - [bɪˈlif] - віра - B1
believe - v. - [bɪˈliv] - вірити - A1
bell - n. - [bɛl] - дзвін - B1
belong - v. - [bɪˈlɔŋ] - належати - A2
below - adv., prep. - [bɪˈloʊ] - нижче, нижче за - A1
belt - n. - [bɛlt] - ремінь - A2
bend - v., n. - [bɛnd] - згинати, поворот - B1
benefit - n. - [ˈbɛnəfɪt], v. - [ˈbɛnəfɪt] - користь, здобуток - A2, B1
bent - adj. - [bɛnt] - зігнутий - B2
best - adj. - [bɛst], adv., n. - [bɛst] - кращий, найкраще - A1, A2, B1
bet - v., n. - [bɛt] - ставити, ставка - B2
better - adj. - [ˈbɛtər], adv. - [ˈbɛtər], n. - [ˈbɛtər] - краще, покращення - A1, A2, B1
between - prep. - [bɪˈtwin], adv. - [bɪˈtwin] - між - A1, A2
beyond - prep., adv. - [bɪˈjɑnd] - за межами - B2
bicycle - n. - [ˈbaɪsɪkl̩] - велосипед - A1
big - adj. - [bɪɡ] - великий - A1
bike - n. - [baɪk] - велосипед - A1
bill - n. - [bɪl], v. - [bɪl] - рахунок, виставляти рахунок - A1, B2
billion - number - [ˈbɪljən] - мільярд - A2
bin - n. - [bɪn] - смітник - A2
biology - n. - [baɪˈɒlədʒi] - біологія - A2
bird - n. - [bɜrd] - птах - A1
birth - n. - [bɜrθ] - народження - A2
birthday - n. - [ˈbɜrθˌdeɪ] - день народження - A1
biscuit - n. - [ˈbɪskɪt] - печиво - A2
bit - n. - [bɪt] - шматок, трошечки - A2
bite - v., n. - [baɪt] - кусати, укус - B1
bitter - adj. - [ˈbɪtər] - гіркий - B2
black - adj., n. - [blæk] - чорний - A1
blame - v., n. - [bleɪm] - винуватити, вина - B2
blank - adj., n. - [blæŋk] - порожній, пропуск - A2
blind - adj. - [blaɪnd] - сліпий - B2
block - n., v. - [blɑk], [blɑk] - блок, блокувати - B1
blog - n. - [blɔɡ] - блог - A1
blonde - adj. - [blɒnd] - блондин/блондка - A1
blood - n. - [blʌd] - кров - A2
blow - v. - [bloʊ] - дути, удар - A2
blue - adj., n. - [bluː] - синій - A1
board - n. - [bɔrd], v. - [bɔrd] - дошка, засідання - A2, B1
boat - n. - [boʊt] - човен - A1
body - n. - [ˈbɒdi] - тіло - A1
boil - v. - [bɔɪl] - кип'ятити - A2
bomb - n., v. - [bɑm] - бомба, бомбити - B1
bond - n. - [bɒnd] - зв'язок - B2
bone - n. - [boʊn] - кістка - A2
book - n. - [bʊk], v. - [bʊk] - книга, бронювати - A1, A2
boot - n. - [buːt] - чобіт - A1
border - n. - [ˈbɔrdər], v. - [ˈbɔrdər] - кордон, межа - B1, B2
bored - adj. - [bɔrd] - нудьгуватий - A1
boring - adj. - [ˈbɔrɪŋ] - нудний - A1
born - v. - [bɔrn] - народжений - A1
borrow - v. - [ˈbɑroʊ] - позичати - A2
boss - n. - [bɔs] - начальник - A2
both - det./pron. - [boʊθ] - обидва - A1
bother - v. - [ˈbɒðər] - турбувати - B1
bottle - n. - [ˈbɑtl̩] - пляшка - A1
bottom - n., adj. - [ˈbɒtəm] - дно, нижній - A2
bowl - n. - [boʊl] - миска - A2
box - n. - [bɒks] - коробка - A1
boy - n. - [bɔɪ] - хлопчик - A1
boyfriend - n. - [ˈbɔɪfrɛnd] - хлопець (по відношенню до дівчини) - A1
brain - n. - [breɪn] - мозок - A2
branch - n. - [bræntʃ] - гілка - B1
brand - n., v. - [brænd] - бренд, марка - B1
brave - adj. - [breɪv] - сміливий - B1
bread - n. - [brɛd] - хліб - A1
break - v., n. - [breɪk] - ламати, перерва - A1
breakfast - n. - [ˈbrɛkfəst] - сніданок - A1
breast - n. - [brɛst] - груди - B2
breath - n. - [brɛθ] - подих - B1
breathe - v. - [brið] - дихати - B1
breathing - n. - [ˈbriðɪŋ] - дихання - B1
bride - n. - [braɪd] - наречена - B1
bridge - n. - [brɪdʒ] - міст - A2
brief - adj. - [briːf] - короткий - B2
bright - adj. - [braɪt] - яскравий - A2
brilliant - adj. - [ˈbrɪljənt] - блискучий - A2
bring - v. - [brɪŋ] - приносити - A1
broad - adj. - [brɔd] - широкий - B2
broadcast - v., n. - [ˈbrɔdˌkæst] - транслювати, трансляція - B2
broken - adj. - [ˈbroʊkən] - зламаний - A2
brother - n. - [ˈbrʌðər] - брат - A1
brown - adj., n. - [braʊn] - коричневий - A1
brush - v., n. - [brʌʃ] - чистити, щітка - A2
bubble - n. - [ˈbʌbl̩] - бульбашка - B1
budget - n. - [ˈbʌdʒɪt] - бюджет - B2
build - v. - [bɪld] - будувати - A1
building - n. - [ˈbɪldɪŋ] - будівля - A1
bullet - n. - [ˈbʊlɪt] - куля - B2
bunch - n. - [bʌntʃ] - пучок - B2
burn - v. - [bɜrn] - палити, горіти, опік - A2, B2
bury - v. - [ˈbɛri] - ховати - B1
bus - n. - [bʌs] - автобус - A1
bush - n. - [bʊʃ] - кущ - B2
business - n. - [ˈbɪznɪs] - бізнес - A1
businessman - n. - [ˈbɪznɪsˌmæn] - бізнесмен - A2
busy - adj. - [ˈbɪzi] - зайнятий - A1
but - conj. - [bət], prep. - [bət] - але, крім - A1, B2
butter - n. - [ˈbʌtər] - масло - A1
button - n. - [ˈbʌtən] - кнопка - A2
buy - v. - [baɪ] - купувати - A1
by - prep. - [baɪ], adv. - [baɪ] - від, біля - A1, B1
bye - exclam. - [baɪ] - пока - A1
cable - n. - [ˈkeɪbl̩] - кабель - B2
cafe - n. - [ˈkæfeɪ] - кафе - A1
cake - n. - [keɪk] - торт - A1
calculate - v. - [ˈkælkjəˌleɪt] - обчислювати - B2
call - v., n. - [kɔl] - дзвонити, виклик - A1
calm - adj., v., n. - [kɑːm] - спокійний, заспокоювати, спокій - B1
camera - n. - [ˈkæmərə] - камера - A1
camp - n., v. - [kæmp] - табір, розташовувати табір - A2
campaign - n., v. - [kæmˈpeɪn] - кампанія, вести кампанію - B1
camping - n. - [ˈkæmpɪŋ] - кемпінг - A2
campus - n. - [ˈkæmpəs] - кампус - B1
can1 - modal v. - [kən] - може (можливість) - A1
can2 - n. - [kæn] - банка - A2
cancel - v. - [ˈkænsəl] - скасовувати - B2
cancer - n. - [ˈkænsər] - рак - B2
candidate - n. - [ˈkændɪdeɪt] - кандидат - B1
cannot - v. - [ˈkænɒt] - не можу - A1
cap - n. - [kæp] - кепка - B1
capable - adj. - [ˈkeɪpəbl̩] - здатний - B2
capacity - n. - [kəˈpæsəti] - місткість - B2
capital - n., adj. - [ˈkæpɪtl̩] - столиця, капітал - A1
captain - n. - [ˈkæptɪn] - капітан - B1
capture - v., n. - [ˈkæptʃər] - захоплювати, захоплення - B2
car - n. - [kɑːr] - автомобіль - A1
card - n. - [kɑːrd] - картка - A1
care - n., v. - [kɛr] - дбати, турбування - A2
career - n. - [kəˈrɪər] - кар'єра - A1
careful - adj. - [ˈkɛrfl̩] - обережний - A2
carefully - adv. - [ˈkɛrfl̩i] - обережно - A2
careless - adj. - [ˈkɛrlɪs] - необережний - B1
carpet - n. - [ˈkɑːrpɪt] - килим - A2
carrot - n. - [ˈkærət] - морква - A1
carry - v. - [ˈkæri] - нести - A1
cartoon - n. - [kɑrˈtuːn] - мультфільм - A2
case - n. - [keɪs] - справа, випадок - A2
cash - n. - [kæʃ] - готівка - A2
cast - n., v. - [kæst] - акторський склад, викидати - B2
castle - n. - [ˈkæsl̩] - замок - A2
cat - n. - [kæt] - кіт - A1
catch - v., n. - [kætʃ] - ловити, лов - A2, B2
category - n. - [ˈkætəɡɔri] - категорія - B1
cause - n., v. - [kɔːz] - причина, викликати - A2
CD - n. - [ˌsiːˈdiː] - компакт-диск - A1
ceiling - n. - [ˈsiːlɪŋ] - стеля - B1
celebrate - v. - [ˈsɛlɪbreɪt] - святкувати - A2
celebration - n. - [ˌsɛlɪˈbreɪʃən] - святкування - B1
celebrity - n. - [sɪˈlɛbrəti] - знаменитість - A2
cell - n. - [sɛl] - клітина - B2
cent - n. - [sɛnt] - цент - A1
central - adj. - [ˈsɛntrəl] - центральний - B1
centre - n. - [ˈsɛntr̩] - центр, середина - A1, v. - B1
century - n. - [ˈsɛntʃəri] - століття - A1
ceremony - n. - [ˈsɛrəmoʊni] - церемонія - B1
certain - adj. - [ˈsɜːrtn̩] - певний - A2
certainly - adv. - [ˈsɜːrtənli] - безперечно - A2
chain - n. - [ʧeɪn], v. - [ʧeɪn] - ланцюг, ланцюгова реакція - B1, B2
chair - n. - [ʧɛr], v. - [ʧɛr] - стілець, очолювати - A1, B2
chairman - n. - [ˈʧɛrˌmæn] - голова (комітету, ради) - B2
challenge - n. - [ˈʧælɪndʒ], v. - [ˈʧælɪndʒ] - виклик, ставити завдання - B1, B2
champion - n. - [ˈʧæmpiən] - чемпіон - B1
chance - n. - [ʧæns] - можливість - A2
change - v., n. - [ʧeɪndʒ] - змінювати, зміна - A1
channel - n. - [ˈʧænəl] - канал - B1
chapter - n. - [ˈʧæptər] - розділ - B1
character - n. - [ˈkærɪktər] - персонаж, характер - A2
characteristic - n., adj. - [ˌkærɪktəˈrɪstɪk] - риса, характеристика, характерний - B2
charge - n., v. - [ʧɑːrdʒ] - збір, заряджати - B1
charity - n. - [ˈʧærəti] - благодійність - A2
chart - n. - [ʧɑːrt], v. - [ʧɑːrt] - діаграма, графік - A1, B2
chat - v., n. - [ʧæt] - балакати, розмова - A2
cheap - adj. - [ʧiːp] - дешевий - A1, adv. - B1
cheat - v., n. - [ʧit] - обманювати, обман - B1
check - v. - [ʧɛk], n. - [ʧɛk] - перевіряти, чек - A1, A2
cheerful - adj. - [ˈʧɪrfl̩] - веселий - B1
cheese - n. - [ʧiz] - сир - A1
chef - n. - [ʃɛf] - шеф-кухар - A2
chemical - adj., n. - [ˈkɛmɪkl̩] - хімічний, хімікат - B1
chemistry - n. - [ˈkɛmɪstri] - хімія - A2
chest - n. - [ʧɛst] - груди, скриня - B1
chicken - n. - [ˈʧɪkɪn] - курка - A1
chief - adj., n. - [ʧiːf] - головний, начальник - B2
child - n. - [ʧaɪld] - дитина - A1
childhood - n. - [ˈʧaɪldhʊd] - дитинство - B1
chip - n. - [ʧɪp] - чіп, чіпс - A2
chocolate - n. - [ˈtʃɑːklɪt] - шоколад - A1
choice - n. - [ʧɔɪs] - вибір - A2
choose - v. - [ʧuːz] - вибирати - A1
church - n. - [ʧɜːrtʃ] - церква - A2
cigarette - n. - [ˌsɪɡəˈrɛt] - сигарета - A2
cinema - n. - [ˈsɪnəmə] - кінотеатр - A1
circle - n., v. - [ˈsɜːrkl̩] - коло, обертати - A2
circumstance - n. - [ˈsɜːrkəmstəns] - обставина - B2
cite - v. - [saɪt] - цитувати - B2
citizen - n. - [ˈsɪtɪzn̩] - громадянин - B2
city - n. - [ˈsɪti] - місто - A1
civil - adj. - [ˈsɪvl̩] - громадянський - B2
claim - v., n. - [kleɪm] - вимагати, претензія - B1
class - n. - [klæs] - клас - A1
classic - adj., n. - [ˈklæsɪk] - класичний, класика - B2
classical - adj. - [ˈklæsɪkl̩] - класичний - A2
classroom - n. - [ˈklæsruːm] - класна кімната - A1
clause - n. - [klɔːz] - пункт, стаття (договору) - B1
clean - adj., v. - [kliːn] - чистий, прибирати - A1
clear - adj. - [klɪr] - ясний - A2, v. - [klɪr] - очистити - B1
clearly - adv. - [ˈklɪrli] - чітко, ясно - A2
clever - adj. - [ˈklɛvər] - розумний - A2
click - v., n. - [klɪk] - клацати, клацання - B1
client - n. - [klaɪənt] - клієнт - B1
climate - n. - [ˈklaɪmət] - клімат - A2
climb - v., n. - [klaɪm] - вилазити, підніматися, підйом - A1, B1
clock - n. - [klɑːk] - годинник - A1
close1 - v. - [kloʊz] - закривати - A1, n. - B2
close2 - adj. - [kloʊs], adv. - [kloʊs] - близький, близько - A2, B1
closed - adj. - [kloʊzd] - закритий - A2
closely - adv. - [ˈkloʊsli] - тісно, уважно - B2
cloth - n. - [klɔːθ] - тканина - B1
clothes - n. - [kloʊðz] - одяг - A1
clothing - n. - [ˈkloʊðɪŋ] - одяг - A2
cloud - n. - [klaʊd] - хмара - A2
club - n. - [klʌb] - клуб - A1
clue - n. - [kluː] - слід, підказка - B1
coach - n. - [koʊʧ], v. - [koʊʧ] - тренер, навчати - A2, B1
coal - n. - [koʊl] - вугілля - B1
coast - n. - [koʊst] - узбережжя - A2
coat - n. - [koʊt] - пальто - A1
code - n. - [koʊd] - код - A2
coffee - n. - [ˈkɒfi] - кава - A1
coin - n. - [kɔɪn] - монета - B1
cold - adj., n. - [koʊld] - холодний, застуда - A1
collapse - v., n. - [kəˈlæps] - обвалювати, обвал - B2
colleague - n. - [ˈkɒliːɡ] - колега - A2
collect - v. - [kəˈlɛkt] - збирати - A2
collection - n. - [kəˈlɛkʃən] - колекція - B1
college - n. - [ˈkɒlɪdʒ] - коледж - A1
colour - n. - [ˈkʌlər] - колір - A1
coloured - adj. - [ˈkʌlərd] - кольоровий - B1
column - n. - [ˈkɑːləm] - колона, стовп - A2
combination - n. - [ˌkɒmbɪˈneɪʃən] - комбінація - B2
combine - v. - [kəmˈbaɪn] - об'єднувати - B1
come - v. - [kʌm] - приходити - A1
comedy - n. - [ˈkɒmədi] - комедія - A2
comfort - n., v. - [ˈkʌmfərt] - комфорт, зручність, комфортно - B2
comfortable - adj. - [ˈkʌmfərtəbl̩] - зручний - A2
command - n., v. - [kəˈmænd] - команда, веління - B2
comment - n. - [ˈkɒmɛnt], v. - [ˈkɒmɛnt] - коментар, коментувати - A2, B1
commercial - adj., n. - [kəˈmɜːrʃəl] - комерційний, реклама - B1
commission - n., v. - [kəˈmɪʃən] - комісія, замовляти - B2
commit - v. - [kəˈmɪt] - зобов'язувати, здійснювати - B1
commitment - n. - [kəˈmɪtmənt] - зобов'язання - B2
committee - n. - [kəˈmɪti] - комітет - B2
common - adj., n. - [ˈkɒmən] - загальний, звичайний - A1
commonly - adv. - [ˈkɒmənli] - зазвичай - B2
communicate - v. - [kəˈmjuːnɪkeɪt] - спілкуватися - A2
communication - n. - [kəˌmjuːnɪˈkeɪʃən] - комунікація - B1
community - n. - [kəˈmjuːnəti] - спільнота - A2
company - n. - [ˈkʌmpəni] - компанія - A1
compare - v. - [kəmˈpɛr] - порівнювати - A1
comparison - n. - [kəmˈpærɪsn̩] - порівняння - B1
compete - v. - [kəmˈpiːt] - конкурувати - A2
competition - n. - [ˌkɒmpɪˈtɪʃən] - конкуренція - A2
competitive - adj. - [kəmˈpɛtɪtɪv] - конкурентний - B1
competitor - n. - [kəmˈpɛtɪtər] - конкурент - B1
complain - v. - [kəmˈpleɪn] - скаржитися - A2
complaint - n. - [kəmˈpleɪnt] - скарга - B1
complete - adj., v. - [kəmˈpliːt] - повний, завершувати - A1
completely - adv. - [kəmˈpliːtli] - повністю - A2
complex - adj. - [ˈkɒmpleks], n. - [ˈkɒmpleks] - складний, комплекс - B1, B2
complicated - adj. - [ˈkɒmplɪˌkeɪtɪd] - ускладнений - B2
component - n. - [kəmˈpoʊnənt] - компонент - B2
computer - n. - [kəmˈpjuːtər] - комп'ютер - A1
concentrate - v. - [ˈkɒnsəntreɪt] - концентруватися - B1
concentration - n. - [ˌkɒnsənˈtreɪʃən] - концентрація - B2
concept - n. - [ˈkɒnsɛpt] - концепція - B2
concern - n., v. - [kənˈsɜrn] - стосуватися, турбота - B2
concerned - adj. - [kənˈsɜrnd] - занепокоєний - B2
concert - n. - [ˈkɒnsərt] - концерт - A1
conclude - v. - [kənˈkluːd] - висновок - B1
conclusion - n. - [kənˈkluːʒən] - висновок - B1
condition - n. - [kənˈdɪʃən] - стан, умова - A2
conduct - v., n. - [kənˈdʌkt] - поведінка, проводити - B2
conference - n. - [ˈkɒnfərəns] - конференція - A2
confidence - n. - [ˈkɒnfɪdəns] - впевненість - B2
confident - adj. - [ˈkɒnfɪdənt] - впевнений - B1
confirm - v. - [kənˈfɜrm] - підтверджувати - B1
conflict - n., v. - [ˈkɒnflɪkt] - конфлікт, конфліктувати - B2
confuse - v. - [kənˈfjuz] - плутати - B1
confused - adj. - [kənˈfjuzd] - збентежений - B1
confusing - adj. - [kənˈfjuzɪŋ] - заплутаний - B2
connect - v. - [kəˈnɛkt] - з'єднувати - A2
connected - adj. - [kəˈnɛktɪd] - пов'язаний - A2
connection - n. - [kəˈnɛkʃən] - зв'язок - B1
conscious - adj. - [ˈkɒnʃəs] - свідомий - B2
consequence - n. - [ˈkɒnsɪkwəns] - наслідок - B1
conservative - adj., n. - [kənˈsɜrvətɪv] - консервативний, консерватор - B2
consider - v. - [kənˈsɪdər] - вважати - A2
consideration - n. - [kənˌsɪdəˈreɪʃən] - розгляд, увага - B2
consist - v. - [kənˈsɪst] - складатися - B1
consistent - adj. - [kənˈsɪstənt] - послідовний - B2
constant - adj. - [ˈkɒnstənt] - постійний - B2
constantly - adv. - [ˈkɒnstəntli] - постійно - B2
construct - v. - [kənˈstrʌkt] - будувати - B2
construction - n. - [kənˈstrʌkʃən] - будівництво - B2
consume - v. - [kənˈsuːm] - споживати - B1
consumer - n. - [kənˈsuːmər] - споживач - B1
contact - n., v. - [ˈkɒntækt] - контакт, зв'язок - B1
contain - v. - [kənˈteɪn] - містити - A2
container - n. - [kənˈteɪnər] - контейнер - B1
contemporary - adj. - [kənˈtɛmpəˌrɛri] - сучасний - B2
content1 - n. - [ˈkɒntɛnt] - задоволеність - B1
contest - n., v. - [ˈkɒntɛst] - конкурс, конкурентувати - B2
context - n. - [ˈkɒntɛkst] - контекст - A2
continent - n. - [ˈkɒntɪnənt] - континент - A2
continue - v. - [kənˈtɪnjuː] - продовжувати - A2
continuous - adj. - [kənˈtɪnjuəs] - постійний - B1
contract - n., v. - [ˈkɒntrækt] - контракт, угода - B2
contrast - n., v. - [ˈkɒntræst] - контраст, відмінність - B1
contribute - v. - [kənˈtrɪbjuːt] - внести вклад - B2
contribution - n. - [ˌkɒntrɪˈbjuːʃən] - внесок - B2
control - n., v. - [kənˈtrəʊl] - контроль, керувати - A2
convenient - adj. - [kənˈviːniənt] - зручний - B1
conversation - n. - [ˌkɒnvəˈseɪʃən] - розмова - A1
convert - v. - [kənˈvɜrt] - конвертувати - B2
convince - v. - [kənˈvɪns] - переконувати - B1
convinced - adj. - [kənˈvɪnst] - переконаний - B2
cook - v. - [kʊk], n. - [kʊk] - готувати, кухар - A1, A2
cooker - n. - [ˈkʊkər] - кухонна плита - A2
cooking - n. - [ˈkʊkɪŋ] - готування - A1
cool - adj. - [kuːl], v. - [kuːl] - прохолодний, охолоджувати - A1, B1
copy - n., v. - [ˈkɒpi] - копія, копіювати - A2
core - n., adj. - [kɔːr] - ядро, основний - B2
corner - n. - [ˈkɔːrnər] - кут - A2
corporate - adj. - [ˈkɔːrpərɪt] - корпоративний - B2
correct - adj., v. - [kəˈrɛkt] - правильний, виправляти - A1
correctly - adv. - [kəˈrɛktli] - правильно - A2
cost - n., v. - [kɒst] - вартість, коштувати - A1
costume - n. - [ˈkɒstjuːm] - костюм - B1
cottage - n. - [ˈkɒtɪdʒ] - котедж - B1
cotton - n. - [ˈkɒtn] - бавовна - B1
could - modal v. - [kʊd] - міг би - A1
council - n. - [ˈkaʊnsəl] - рада - B2
count - v. - [kaʊnt], n. - [kaʊnt] - рахувати, кількість - A2, B1
country - n. - [ˈkʌntri] - країна - A1
countryside - n. - [ˈkʌntrɪsaɪd] - сільська місцевість - B1
county - n. - [ˈkaʊnti] - область - B2
couple - n. - [ˈkʌpl] - пара - A2
courage - n. - [ˈkʌrɪdʒ] - сміливість - B2
course - n. - [kɔːrs] - курс, шлях - A1
court - n. - [kɔːrt] - суд - B1
cousin - n. - [ˈkʌzɪn] - двоюрідний брат/сестра - A1
cover - v. - [ˈkʌvər], n. - [ˈkʌvər] - покривати, обкладинка - A2, B1
covered - adj. - [ˈkʌvərd] - прикритий - B1
cow - n. - [kaʊ] - корова - A1
crash - n., v. - [kræʃ] - аварія, зіткнення; [kræʃ] - зіткнутися - B2
crazy - adj. - [ˈkreɪzi] - божевільний, сумний - A2
cream - n., adj. - [kriːm] - вершковий, вершки; [kriːm] - вершковий - A1, B1
create - v. - [kriˈeɪt] - створювати - A1
creation - n. - [kriˈeɪʃən] - створення - B2
creative - adj. - [kriˈeɪtɪv] - творчий - A2
creature - n. - [ˈkriːtʃər] - створіння - B2
credit - n., v. - [ˈkrɛdɪt] - кредит; [ˈkrɛdɪt] - відзначати, давати заслугу - A2, B2
crew - n. - [kruː] - екіпаж, група - B2
crime - n. - [kraɪm] - злочин - A2
criminal - n. - [ˈkrɪmɪnl], adj. - [ˈkrɪmɪnl] - злочинець, злочинний - A2, B1
crisis - n. - [ˈkraɪsɪs] - криза - B2
criterion - n. - [kraɪˈtɪəriən] - критерій - B2
critic - n. - [ˈkrɪtɪk] - критик - B2
critical - adj. - [ˈkrɪtɪkəl] - критичний - B2
criticism - n. - [ˈkrɪtɪsɪzəm] - критика - B2
criticize - v. - [ˈkrɪtɪˌsaɪz] - критикувати - B2
crop - n. - [krɒp] - урожай - B2
cross - v., n. - [krɒs] - перетинати; хрест - A2
crowd - n. - [kraʊd] - натовп - A2
crowded - adj. - [ˈkraʊdɪd] - переповнений - A2
crucial - adj. - [ˈkruːʃəl] - важливий, рішучий - B2
cruel - adj. - [kruːəl] - жорстокий - B1
cry - v. - [kraɪ], n. - [kraɪ] - кричати; крик - A2, B2
cultural - adj. - [ˈkʌltʃərəl] - культурний - B1
culture - n. - [ˈkʌltʃər] - культура - A1
cup - n. - [kʌp] - чашка - A1
cupboard - n. - [ˈkʌbərd] - шафа, кухонний шафчик - A2
cure - v., n. - [kjʊər] - лікувати; лікування - B2
curly - adj. - [ˈkɜːrli] - кучерявий - A2
currency - n. - [ˈkʌrənsi] - валюта - B1
current - adj. - [ˈkʌrənt], n. - [ˈkʌrənt] - поточний; течія - B1, B2
currently - adv. - [ˈkɜːrəntli] - в даний час - B1
curtain - n. - [ˈkɜːrtən] - занавіска - B1
curve - n., v. - [kɜːrv] - крива; бути кривою - B2
curved - adj. - [kɜːrvd] - криволінійний - B2
custom - n. - [ˈkʌstəm] - звичай - B1
customer - n. - [ˈkʌstəmər] - клієнт - A1
cut - v. - [kʌt], n. - [kʌt] - різати; поріз - A1
cycle - n., v. - [ˈsaɪkl] - цикл; їздити на велосипеді - A2
dad - n. - [dæd] - тато - A1
daily - adj. - [ˈdeɪli], adv. - [ˈdeɪli] - щоденний; щоденно - A2, B1
damage - n., v. - [ˈdæmɪdʒ] - збиток; завдавати шкоду - B1
dance - n., v. - [dæns] - танець; танцювати - A1
dancer - n. - [ˈdænsər] - танцівниця - A1
dancing - n. - [ˈdænsɪŋ] - танці - A1
danger - n. - [ˈdeɪndʒər] - небезпека - A2
dangerous - adj. - [ˈdeɪndʒərəs] - небезпечний - A1
dark - adj. - [dɑːrk], n. - [dɑːrk] - темний; темрява - A1, A2
data - n. - [ˈdeɪtə] - дані - A2
date - n. - [deɪt], v. - [deɪt] - дата; датувати - A1, B2
daughter - n. - [ˈdɔːtər] - дочка - A1
day - n. - [deɪ] - день - A1
dead - adj. - [dɛd] - мертвий - A2
deal - v. - [diːl], n. - [diːl] - угода; мати справу - A2, B1
dear - adj. - [dɪər], exclam. - [dɪər] - дорогий; о, мій! - A1, A2
death - n. - [dɛθ] - смерть - A2
debate - n., v. - [dɪˈbeɪt] - дебати; обговорювати - B2
debt - n. - [dɛt] - борг - B2
decade - n. - [ˈdɛkeɪd] - десятиліття - B1
December - n. - [dɪˈsɛmbər] - грудень - A1
decent - adj. - [ˈdiːsənt] - приличний - B2
decide - v. - [dɪˈsaɪd] - вирішувати - A1
decision - n. - [dɪˈsɪʒən] - рішення - A2
declare - v. - [dɪˈklɛər] - оголошувати - B2
decline - v., n. - [dɪˈklaɪn] - відмовлятися; зменшення - B2
decorate - v. - [ˈdɛkəreɪt] - прикрашати - B1
decoration - n. - [ˌdɛkəˈreɪʃən] - прикраса - B2
decrease - v., n. - [dɪˈkriːs] - зменшувати; зменшення - B2
deep - adj. - [diːp], adv. - [diːp] - глибокий; глибоко - A2, B1
deeply - adv. - [ˈdiːpli] - глибоко - B2
defeat - v., n. - [dɪˈfiːt] - перемагати; поразка - B2
defence - n. - [dɪˈfɛns] - оборона - B2
defend - v. - [dɪˈfɛnd] - захищати - B2
define - v. - [dɪˈfaɪn] - визначати - B1
definite - adj. - [ˈdɛfɪnɪt] - визначений - B1
definitely - adv. - [ˈdɛfɪnɪtli] - безперечно - A2
definition - n. - [ˌdɛfɪˈnɪʃən] - визначення - B1
degree - n. - [dɪˈɡriː] - ступінь, градус - A2
delay - v., n. - [dɪˈleɪ] - затримувати; затримка - B2
deliberate - adj. - [dɪˈlɪbərɪt] - розсудливий - B2
deliberately - adv. - [dɪˈlɪbərətli] - усвідомлено - B2
delicious - adj. - [dɪˈlɪʃəs] - смачний - A1
delight - v., n. - [dɪˈlaɪt] - вражати чудово; захоплення - B2
delighted - adj. - [dɪˈlaɪtɪd] - захоплений - B2
deliver - v. - [dɪˈlɪvər] - доставляти - B1
delivery - n. - [dɪˈlɪvəri] - доставка - B2
demand - n., v. - [dɪˈmænd] - вимога; вимагати - B2
demonstrate - v. - [ˈdɛmənstreɪt] - демонструвати - B2
dentist - n. - [ˈdɛntɪst] - стоматолог - A2
deny - v. - [dɪˈnaɪ] - заперечувати - B2
department - n. - [dɪˈpɑːrtmənt] - відділ - A2
departure - n. - [dɪˈpɑːrtʃər] - від'їзд - B1
depend - v. - [dɪˈpɛnd] - залежати - A2
depressed - adj. - [dɪˈprɛst] - пригнічений - B2
depressing - adj. - [dɪˈprɛsɪŋ] - пригнічуючий - B2
depth - n. - [dɛpθ] - глибина - B2
describe - v. - [dɪˈskraɪb] - описувати - A1
description - n. - [dɪˈskrɪpʃən] - опис - A1
desert - n., v. - [ˈdezət]; [dɪˈzɜːt] - пустеля; покидати - A2, B2
deserve - v. - [dɪˈzɜːv] - заслуговувати - B2
design - n., v. - [dɪˈzaɪn] - дизайн; проектувати - A1
designer - n. - [dɪˈzaɪnər] - дизайнер - A2
desire - n., v. - [dɪˈzaɪər]; [dɪˈzaɪər] - бажання; бажати - B2
desk - n. - [dɛsk] - стіл - A1
desperate - adj. - [ˈdɛspərɪt] - відчайдушний - B2
despite - prep. - [dɪˈspaɪt] - незважаючи на - B1
destination - n. - [ˌdɛstɪˈneɪʃən] - місце призначення - B1
destroy - v. - [dɪˈstrɔɪ] - знищувати - A2
detail - n. - [ˈdiːteɪl], v. - [dɪˈteɪl] - деталь; деталізувати - A1, B2
detailed - adj. - [ˈdiːteɪld] - детальний - B2
detect - v. - [dɪˈtɛkt] - виявляти - B2
detective - n. - [dɪˈtɛktɪv] - детектив - A2
determine - v. - [dɪˈtɜːrmɪn] - визначати - B1
determined - adj. - [dɪˈtɜːrmɪnd] - визначений - B1
develop - v. - [dɪˈvɛləp] - розвивати - A2
development - n. - [dɪˈvɛləpmənt] - розвиток - B1
device - n. - [dɪˈvaɪs] - пристрій - A2
diagram - n. - [ˈdaɪəɡræm] - діаграма - B1
dialogue - n. - [ˈdaɪəlɒɡ] - діалог - A1
diamond - n. - [ˈdaɪəmənd] - діамант - B1
diary - n. - [ˈdaɪəri] - щоденник - A2
dictionary - n. - [ˈdɪkʃəˌnɛri] - словник - A1
die - v. - [daɪ] - померти - A1
diet - n. - [daɪət] - дієта - A1
difference - n. - [ˈdɪfərəns] - відмінність - A1
different - adj. - [ˈdɪfərənt] - різний - A1
differently - adv. - [ˈdɪfərəntli] - по-різному - A2
difficult - adj. - [ˈdɪfɪkəlt] - складний - A1
difficulty - n. - [ˈdɪfɪkəlti] - трудність - B1
dig - v. - [dɪɡ] - копати - B2
digital - adj. - [ˈdɪdʒɪtl] - цифровий - A2
dinner - n. - [ˈdɪnər] - обід - A1
direct - adj. - [dɪˈrɛkt], v. - [dɪˈrɛkt], adv. - [dɪˈrɛkt] - прямий; направляти; безпосередньо - A2, B1
direction - n. - [dɪˈrɛkʃən] - напрямок - A2
directly - adv. - [dɪˈrɛktli] - безпосередньо - B1
director - n. - [dɪˈrɛktər] - режисер; директор - A2
dirt - n. - [dɜːrt] - бруд - B1
dirty - adj. - [ˈdɜːrti] - брудний - A1
disadvantage - n. - [ˌdɪsədˈvæntɪdʒ] - невигода - B1
disagree - v. - [ˌdɪsəˈɡriː] - не погоджуватися - A2
disappear - v. - [ˌdɪsəˈpɪər] - зникати - A2
disappointed - adj. - [ˌdɪsəˈpɔɪntɪd] - розчарований - B1
disappointing - adj. - [ˌdɪsəˈpɔɪntɪŋ] - розчаровуючий - B1
disaster - n. - [dɪˈzæstər] - катастрофа - A2
disc - n. - [dɪsk] - диск - B2
discipline - n. - [ˈdɪsəplɪn] - дисципліна - B2
discount - n. - [ˈdɪskaʊnt], v. - [dɪsˈkaʊnt] - знижка; надавати знижку - B1, B2
discover - v. - [dɪˈskʌvər] - відкривати - A2
discovery - n. - [dɪˈskʌvəri] - відкриття - A2
discuss - v. - [dɪˈskʌs] - обговорювати - A1
discussion - n. - [dɪˈskʌʃən] - обговорення - A2
disease - n. - [dɪˈziz] - захворювання - A2
dish - n. - [dɪʃ] - страва - A1
dishonest - adj. - [dɪsˈɒnɪst] - недобросовісний - B2
dislike - v., n. - [dɪsˈlaɪk] - не любити; неприязнь - B1
dismiss - v. - [dɪsˈmɪs] - звільняти - B2
display - v., n. - [dɪˈspleɪ] - відображати; виставка - B2
distance - n. - [ˈdɪstəns] - відстань - A2
distribute - v. - [dɪˈstrɪbjuːt] - розподіляти - B2
distribution - n. - [ˌdɪstrɪˈbjuːʃən] - розподіл - B2
district - n. - [ˈdɪstrɪkt] - район - B2
divide - v., n. - [dɪˈvaɪd] - ділити; поділ - B1, B2
division - n. - [dɪˈvɪʒən] - поділ - B2
divorced - adj. - [dɪˈvɔrst] - розлучений - A2
do1 - v., auxiliary v. - [duː] - робити, виконувати - A1
doctor - n. - [ˈdɒktər] - лікар - A1
document - n. - [ˈdɒkjʊmənt], v. - [ˈdɒkjʊmɛnt] - документ; документувати - A2, B2
documentary - n. - [ˌdɒkjʊˈmɛntri] - документальний фільм - B1
dog - n. - [dɒɡ] - собака - A1
dollar - n. - [ˈdɒlər] - долар - A1
domestic - adj. - [dəˈmɛstɪk] - домашній, внутрішній - B2
dominate - v. - [ˈdɒmɪneɪt] - домінувати - B2
donate - v. - [ˈdəʊneɪt] - пожертвувати - B1
door - n. - [dɔːr] - двері - A1
double - adj., det., pron., v. - [ˈdʌbl], adv. - [ˈdʌbl] - подвійний; подвійно - A2, B1
doubt - n., v. - [daʊt] - сумнів; сумніватися - B1
down - adv., prep. - [daʊn] - вниз; внизу - A1
download - v., n. - [ˈdaʊnˌloʊd] - завантажувати; завантаження - A2
downstairs - adv. - [daʊnˈstɛrz], adj. - [daʊnˈstɛrz] - вниз по сходах; на нижньому поверсі - A1, A2
downwards - adv. - [ˈdaʊnˌwərdz] - вниз - B2
dozen - n., det. - [ˈdʌzən] - дюжина; десяток - B2
draft - n., v. - [dræft] - чернетка; складати проект - B2
drag - v. - [dræɡ] - тягти - B2
drama - n. - [ˈdræmə] - драма - A2
dramatic - adj. - [drəˈmætɪk] - драматичний - B2
draw - v. - [drɔː] - малювати - A1
drawing - n. - [ˈdrɔːɪŋ] - малюнок - A2
dream - n., v. - [driːm] - мрія; мріяти - A2
dress - n., v. - [drɛs] - сукня; одягатися - A1
dressed - adj. - [drɛst] - одягнений - B1
drink - n., v. - [drɪŋk] - напій; пити - A1
drive - v. - [draɪv], n. - [draɪv] - водити машину; поїздка - A1, A2
driver - n. - [ˈdraɪvər] - водій - A1
driving - n. - [ˈdraɪvɪŋ] - водіння - A2
drop - v. - [drɒp], n. - [drɒp] - крапля; падати - A2, B1
drug - n. - [drʌɡ] - наркотик - A2
drum - n. - [drʌm] - барабан - B1
drunk - adj. - [drʌŋk] - п'яний - B1
dry - adj., v. - [draɪ] - сухий; сушити - A2
due - adj. - [djuː] - через, наступний - B1
during - prep. - [ˈdjʊrɪŋ] - під час - A1
dust - n. - [dʌst] - пил - B1
duty - n. - [ˈdjuːti] - обов'язок - B1
DVD - n. - [ˌdiːviːˈdiː] - DVD - A1
each - det./pron./adv. - [iːʧ] - кожен; кожний - A1
ear - n. - [ɪər] - вухо - A1
early - adj., adv. - [ˈɜːrli] - ранній; рано - A1
earn - v. - [ɜːrn] - заробляти - A2
earth - n. - [ɜːrθ] - земля - A2
earthquake - n. - [ˈɜːrθˌkweɪk] - землетрус - B1
easily - adv. - [ˈiːzɪli] - легко - A2
east - n., adj., adv. - [iːst] - схід; східний; на схід - A1
eastern - adj. - [ˈiːstərn] - східний - B1
easy - adj. - [ˈiːzi] - легкий - A1
eat - v. - [iːt] - їсти - A1
economic - adj. - [ˌiːkəˈnɒmɪk] - економічний - B1
economy - n. - [ɪˈkɒnəmi] - економіка - B1
edge - n. - [ɛdʒ] - край - B1
edit - v. - [ˈɛdɪt] - редагувати - B2
edition - n. - [ɪˈdɪʃən] - видання - B2
editor - n. - [ˈɛdɪtər] - редактор - B1
educate - v. - [ˈɛdʒʊkeɪt] - навчати - B1
educated - adj. - [ˈɛdʒʊkeɪtɪd] - освічений - B1
education - n. - [ˌɛdʒʊˈkeɪʃən] - освіта - A2
educational - adj. - [ˌɛdʒʊˈkeɪʃənl] - освітній - B1
effect - n. - [ɪˈfɛkt] - ефект - A2
effective - adj. - [ɪˈfɛktɪv] - ефективний - B1
effectively - adv. - [ɪˈfɛktɪvli] - ефективно - B1
efficient - adj. - [ɪˈfɪʃənt] - ефективний - B2
effort - n. - [ˈɛfət] - зусилля - B1
egg - n. - [ɛɡ] - яйце - A1
eight - number - [eɪt] - вісім - A1
eighteen - number - [ɪˈtiːn] - вісімнадцять - A1
eighty - number - [ˈeɪti] - вісімдесят - A1
either - det./pron., adv. - [ˈaɪðər] - будь-який; один з двох; або - A2
elderly - adj. - [ˈɛldərli] - похилого віку - B2
elect - v. - [ɪˈlɛkt] - вибирати - B2
election - n. - [ɪˈlɛkʃən] - вибори - B1
electric - adj. - [ɪˈlɛktrɪk] - електричний - A2
electrical - adj. - [ɪˈlɛktrɪkəl] - електричний - A2
electricity - n. - [ɪˌlɛkˈtrɪsɪti] - електрика - A2
electronic - adj. - [ɪlɛkˈtrɒnɪk] - електронний - A2
element - n. - [ˈɛlɪmənt] - елемент - B1
elephant - n. - [ˈɛlɪfənt] - слон - A1
eleven - number - [ɪˈlɛvən] - одинадцять - A1
else - adv. - [ɛls] - ще; інакше - A1
elsewhere - adv. - [ɛlsˈwɛr] - в іншому місці - B2
email - n., v. - [ˈiːmeɪl] - електронна пошта; надсилати емейл - A1
embarrassed - adj. - [ɪmˈbærəst] - сором'язливий - B1
embarrassing - adj. - [ɪmˈbærəsɪŋ] - неприємний, неловкий - B1
emerge - v. - [ɪˈmɜːdʒ] - виходити, виригати - B2
emergency - n. - [ɪˈmɜːdʒənsi] - надзвичайна ситуація - B1
emotion - n. - [ɪˈməʊʃən] - емоція - B1
emotional - adj. - [ɪˈməʊʃənl] - емоційний - B2
emphasis - n. - [ˈɛmfəsɪs] - наголос - B2
emphasize - v. - [ˈɛmfəˌsaɪz] - наголосити - B2
employ - v. - [ɪmˈplɔɪ] - працевлаштовувати - A2
employee - n. - [ɪmˈplɔɪiː] - співробітник - A2
employer - n. - [ɪmˈplɔɪər] - роботодавець - A2
employment - n. - [ɪmˈplɔɪmənt] - працевлаштування - B1
empty - adj. - [ˈɛmpti], v. - [ˈɛmpti] - порожній; вивантажувати - A2, B1
enable - v. - [ɪnˈeɪbl] - дозволяти, забезпечувати можливість - B2
encounter - v., n. - [ɪnˈkaʊntər] - зустрічати; зіткнення - B2
encourage - v. - [ɪnˈkʌrɪdʒ] - заохочувати - B1
end - n., v. - [ɛnd] - кінець; закінчувати - A1
ending - n. - [ˈɛndɪŋ] - закінчення - A2
enemy - n. - [ˈɛnəmi] - ворог - B1
energy - n. - [ˈɛnərdʒi] - енергія - A2
engage - v. - [ɪnˈɡeɪdʒ] - залучати - B2
engaged - adj. - [ɪnˈɡeɪdʒd] - заручений, зайнятий - B1
engine - n. - [ˈɛndʒɪn] - двигун - A2
engineer - n. - [ˌɛndʒɪˈnɪr] - інженер - A2
engineering - n. - [ˌɛndʒɪˈnɪrɪŋ] - інженерія - B1
enhance - v. - [ɪnˈhæns] - підвищувати, поліпшувати - B2
enjoy - v. - [ɪnˈdʒɔɪ] - насолоджуватися - A1
enormous - adj. - [ɪˈnɔrməs] - величезний - A2
enough - det., pron., adv. - [ɪˈnʌf] - достатньо - A1
enquiry - n. - [ɪnˈkwaɪri] - запитання, дослідження - B2
ensure - v. - [ɛnˈʃʊr] - забезпечувати, гарантувати - B2
enter - v. - [ˈɛntər] - входити - A2
entertain - v. - [ˌɛntərˈteɪn] - розважати - B1
entertainment - n. - [ˌɛntərˈteɪnmənt] - розваги - B1
enthusiasm - n. - [ɪnˈθjuːziæzəm] - ентузіазм - B2
enthusiastic - adj. - [ɛnˌθuːziˈæstɪk] - ентузіастичний - B2
entire - adj. - [ɪnˈtaɪər] - цілий - B2
entirely - adv. - [ɪnˈtaɪərli] - повністю - B2
entrance - n. - [ˈɛntrəns] - вхід - B1
entry - n. - [ˈɛntri] - вхід, запис - B1
environment - n. - [ɪnˈvaɪrənmənt] - навколишнє середовище - A2
environmental - adj. - [ɪnˌvaɪrənˈmɛntəl] - екологічний - B1
episode - n. - [ˈɛpɪsoʊd] - епізод - B1
equal - adj., v. - [ˈiːkwəl], n. - [ˈiːkwəl] - рівний; рівняти; рівнина - B1, B2
equally - adv. - [ˈiːkwəli] - рівно - B1
equipment - n. - [ɪˈkwɪpmənt] - обладнання - A2
error - n. - [ˈɛrər] - помилка - A2
escape - v., n. - [ɪˈskeɪp] - уникати; втеча - B1
especially - adv. - [ɪˈspɛʃəli] - особливо - A2
essay - n. - [ˈɛseɪ] - есе - A2
essential - adj. - [ɪˈsɛnʃəl] - суттєвий - B1
establish - v. - [ɪˈstæblɪʃ] - засновувати - B2
estate - n. - [ɪˈsteɪt] - маєток - B2
estimate - v., n. - [ˈɛstɪmeɪt] - оцінювати; оцінка - B2
ethical - adj. - [ˈɛθɪkəl] - етичний - B2
euro - n. - [ˈjʊəroʊ] - євро - A1
evaluate - v. - [ɪˈvæljueɪt] - оцінювати - B2
even - adv. - [ˈivən], adj. - [ˈivən] - навіть - A1, B2
evening - n. - [ˈiːvnɪŋ] - вечір - A1
event - n. - [ɪˈvɛnt] - подія - A1
eventually - adv. - [ɪˈvɛntʃuəli] - в кінці кінців - B1
ever - adv. - [ˈɛvər] - коли-небудь - A1
every - det. - [ˈɛvri] - кожен - A1
everybody - pron. - [ˈɛvrɪˌbɒdi] - кожен, усі - A1
everyday - adj. - [ˌɛvrɪˈdeɪ] - щоденний - A2
everyone - pron. - [ˈɛvrɪwʌn] - кожен - A1
everything - pron. - [ˈɛvrɪˌθɪŋ] - все - A1
everywhere - adv. - [ˌɛvrɪˈwɛər] - всюди - A2
evidence - n. - [ˈɛvɪdəns] - доказ - A2
evil - adj., n. - [ˈiːvəl] - злий; зло - B2
exact - adj. - [ɪɡˈzækt] - точний - A2
exactly - adv. - [ɪɡˈzæktli] - точно - A2
exam - n. - [ɪɡˈzæm] - іспит - A1
examination - n. - [ɪɡˌzæmɪˈneɪʃən] - іспит, огляд - B2
examine - v. - [ɪɡˈzæmɪn] - обстежувати - B1
example - n. - [ɪɡˈzæmpəl] - приклад - A1
excellent - adj. - [ˈɛksələnt] - відмінний - A2
except - prep. - [ɪkˈsɛpt], conj. - [ɪkˈsɛpt] - крім - A2, B1
exchange - n., v. - [ɪksˈʧeɪndʒ] - обмін; обмінювати - B1
excited - adj. - [ɪkˈsaɪtɪd] - захоплений - A1
excitement - n. - [ɪkˈsaɪtmənt] - захоплення - B1
exciting - adj. - [ɪkˈsaɪtɪŋ] - захоплюючий - A1
excuse - n., v. - [ɪkˈskjuz] - виправдання; вибачати - B2
executive - n., adj. - [ɪɡˈzɛkjətɪv] - керівник; виконавчий - B2
exercise - n., v. - [ˈɛksərsaɪz] - вправа; виконувати вправи - A1
exhibition - n. - [ˌɛksɪˈbɪʃən] - виставка - B1
exist - v. - [ɪɡˈzɪst] - існувати - A2
existence - n. - [ɪɡˈzɪstəns] - існування - B2
expand - v. - [ɪkˈspænd] - розширювати - B1
expect - v. - [ɪkˈspɛkt] - очікувати - A2
expectation - n. - [ˌɛkspɛkˈteɪʃən] - очікування - B2
expected - adj. - [ɪkˈspɛktɪd] - очікуваний - B1
expedition - n. - [ˌɛkspɪˈdɪʃən] - експедиція - B1
expense - n. - [ɪkˈspɛns] - витрати - B2
expensive - adj. - [ɪkˈspɛnsɪv] - дорогий - A1
experience - n. - [ɪksˈpɪəriəns], v. - [ɪksˈpɪəriəns] - досвід; досвідчувати - A2, B1
experienced - adj. - [ɪksˈpɪəriənst] - досвідчений - B1
experiment - n. - [ɪksˈpɛrɪmənt], v. - [ɪksˈpɛrɪmənt] - експеримент; експериментувати - A2, B1
expert - n., adj. - [ˈɛkspərt] - експерт; кваліфікований - A2
explain - v. - [ɪksˈpleɪn] - пояснювати - A1
explanation - n. - [ˌɛkspləˈneɪʃən] - пояснення - A2
explode - v. - [ɪkˈsploʊd] - вибухати - B1
exploration - n. - [ˌɛkspləˈreɪʃən] - дослідження - B2
explore - v. - [ɪkˈsplɔr] - досліджувати - B1
explosion - n. - [ɪkˈsploʊʒən] - вибух - B1
export - n., v. - [ˈɛkspɔrt] - експорт; експортувати - B1
expose - v. - [ɪkˈspoʊz] - викривати - B2
express - v. - [ɪkˈsprɛs], n. - [ˈɛkspres] - виражати; експрес - A2
expression - n. - [ɪkˈsprɛʃən] - вираз - A2
extend - v. - [ɪkˈstɛnd] - розширювати - B2
extent - n. - [ɪkˈstɛnt] - міра - B2
external - adj. - [ɪkˈstɜrnəl] - зовнішній - B2
extra - adj. - [ˈɛkstrə], n. - [ˈɛkstrə], adv. - [ˈɛkstrə] - додатковий; додаток; додатково - A1, B1
extraordinary - adj. - [ɪkˈstrɔrdəˌnɛri] - надзвичайний - B2
extreme - adj. - [ɪkˈstrim], n. - [ɪkˈstrim] - екстремальний; екстремум - A2, B2
extremely - adv. - [ɪkˈstrimli] - надзвичайно - A2
eye - n. - [aɪ] - око - A1
face - n. - [feɪs], v. - [feɪs] - обличчя; ставити (проблему) - A1, B1
facility - n. - [fəˈsɪləti] - можливість, споруда - B2
fact - n. - [fækt] - факт - A1
factor - n. - [ˈfæktər] - фактор - A2
factory - n. - [ˈfæktəri] - завод - A2
fail - v. - [feɪl] - не вдаватися - A2
failure - n. - [ˈfeɪljər] - невдача - B2
fair - adj. - [fɛr], adv. - [fɛr] - справедливий; чесний - A2
fairly - adv. - [ˈfɛrli] - чесно - B1
faith - n. - [feɪθ] - віра - B2
fall - v. - [fɔl], n. - [fɔl] - падати; падіння - A1, A2
false - adj. - [fɔls] - хибний - A1
familiar - adj. - [fəˈmɪliər] - знайомий - B1
family - n., adj. - [ˈfæməli] - родина; сімейний - A1
famous - adj. - [ˈfeɪməs] - відомий - A1
fan - n. - [fæn] - вентилятор - A2
fancy - v., adj. - [ˈfænsi] - уявляти; фантазійний - B1
fantastic - adj. - [fænˈtæstɪk] - фантастичний - A1
far - adv. - [fɑr], adj. - [fɑr] - далеко; далекий - A1, B1
farm - n. - [fɑrm], v. - [fɑrm] - ферма; господарювати - A1, A2
farmer - n. - [ˈfɑrmər] - фермер - A1
farming - n. - [ˈfɑrmɪŋ] - сільське господарство - A2
fascinating - adj. - [ˈfæsəˌneɪtɪŋ] - захоплюючий - B1
fashion - n. - [ˈfæʃən] - мода - A2
fashionable - adj. - [ˈfæʃənəbl] - модний - B1
fast - adj., adv. - [fæst] - швидкий; швидко - A1
fasten - v. - [ˈfæsən] - застібати - B1
fat - adj. - [fæt], n. - [fæt] - жирний; жир - A1, A2
father - n. - [ˈfɑðər] - батько - A1
fault - n. - [fɔlt] - вина - B2
favour - n. - [ˈfeɪvər], v. - [ˈfeɪvər] - послуга; вподобання - B1, B2
favourite - adj., n. - [ˈfeɪvərɪt] - улюблений - A1
fear - n. - [fɪr], v. - [fɪr] - страх; боятися - A2, B1
feather - n. - [ˈfɛðər] - пір'я - B2
feature - n. - [ˈfiʧər], v. - [ˈfiʧər] - особливість; розміщувати на головній сторінці - A2, B1
February - n. - [ˈfɛbrʊˌɛri] - лютень - A1
fee - n. - [fi] - плата - B2
feed - v. - [fid] - годувати - A2, B2
feedback - n. - [ˈfiˌbæk] - відгук - B2
feel - v. - [fil] - відчувати - A1
feeling - n. - [ˈfiːlɪŋ] - почуття - A1
fellow - adj. - [ˈfɛloʊ] - товариш - B2
female - adj., n. - [ˈfiˌmeɪl] - жіночий; жінка - A2
fence - n. - [fɛns] - паркан - B1
festival - n. - [ˈfɛstəvəl] - фестиваль - A1
few - det./adj., pron. - [fju] - кілька - A1
fiction - n. - [ˈfɪkʃən] - художня література - A2
field - n. - [fild] - поле - A2
fifteen - number - [ˌfɪfˈtin] - п'ятнадцять - A1
fifth - number - [fɪfθ] - п'ятий - A1
fifty - number - [ˈfɪfti] - п'ятдесят - A1
fight - v., n. - [faɪt] - боротися; бійка - A2
fighting - n. - [ˈfaɪtɪŋ] - боротьба - B1
figure - n. - [ˈfɪɡjər], v. - [ˈfɪɡjər] - фігура; уявляти собі - A2, B2
file - n. - [faɪl], v. - [faɪl] - файл; відправляти (документи) - B1, B2
fill - v. - [fɪl] - наповнювати - A1
film - n. - [fɪlm], v. - [fɪlm] - фільм; знімати (фільм) - A1, A2
final - adj. - [ˈfaɪnl], n. - [ˈfaɪnl] - фінальний; фінал - A1, A2
finally - adv. - [ˈfaɪnəli] - нарешті - A2
finance - n., v. - [ˈfaɪnæns] - фінанси; фінансувати - B2
financial - adj. - [faɪˈnænʃəl] - фінансовий - B1
find - v. - [faɪnd] - знаходити - A1
finding - n. - [ˈfaɪndɪŋ] - виявлення - B2
fine - adj. - [faɪn] - відмінний - A1
finger - n. - [ˈfɪŋgər] - палець - A2
finish - v. - [ˈfɪnɪʃ], n. - [ˈfɪnɪʃ] - закінчувати; закінчення - A1, A2
fire - n. - [faɪər], v. - [faɪr] - вогонь; стріляти - A1, B1
firm - n. - [fɜrm] - фірма - B2
first - det./number, adv. - [fɜrst], n. - [fɜrst] - перший; перш за все - A1, A2
firstly - adv. - [ˈfɜrstli] - насамперед - A2
fish - n. - [fɪʃ], v. - [fɪʃ] - риба; ловити рибу - A1, A2
fishing - n. - [ˈfɪʃɪŋ] - риболовля - A2
fit - v., adj. - [fɪt] - підходити; відповідний - A2
fitness - n. - [ˈfɪtnɪs] - фітнес - B1
five - number - [faɪv] - п'ять - A1
fix - v. - [fɪks], n. - [fɪks] - виправляти; ремонт - A2, B2
fixed - adj. - [fɪkst] - фіксований - B1
flag - n. - [flæg] - прапор - B1
flame - n. - [fleɪm] - полум'я - B2
flash - n., v. - [flæʃ] - спалах; спалахувати - B2
flat - n. - [flæt], adj. - [flæt] - квартира; плоский - A1, A2
flexible - adj. - [ˈflɛksəbl] - гнучкий - B2
flight - n. - [flaɪt] - політ - A1
float - v. - [floʊt] - плавати - B2
flood - n., v. - [flʌd] - повінь; заливати - B1
floor - n. - [flɔr] - підлога - A1
flour - n. - [flaʊər] - борошно - B1
flow - v., n. - [floʊ] - течія; течі - B1
flower - n. - [ˈflaʊər] - квітка - A1
flu - n. - [flu] - грип - A2
fly - v. - [flaɪ], n. - [flaɪ] - летіти; муха - A1, A2
flying - n., adj. - [ˈflaɪɪŋ] - льотний; летючий - A2
focus - v., n. - [ˈfoʊkəs] - фокусувати; фокус - A2
fold - v. - [foʊld], n. - [foʊld] - складати; складка - B1, B2
folding - adj. - [ˈfoʊldɪŋ] - складний - B2
folk - n., adj. - [foʊk] - народ; народний - B1
follow - v. - [ˈfɑloʊ] - слідувати - A1
following - adj. - [ˈfɑloʊɪŋ], n. - [ˈfɑloʊɪŋ] - наступний; наступність - A2, B1, B2
food - n. - [fuːd] - їжа - A1
foot - n. - [fʊt] - ступня - A1
football - n. - [ˈfʊtˌbɔl] - футбол - A1
for - prep. - [fɔr] - для - A1
force - n., v. - [fɔrs] - сила; змушувати - B1
foreign - adj. - [ˈfɔrɪn] - іноземний - A2
forest - n. - [ˈfɔrɪst] - ліс - A2
forever - adv. - [fəˈrɛvər] - назавжди - B1
forget - v. - [fərˈgɛt] - забувати - A1
forgive - v. - [fərˈgɪv] - прощати - B2
fork - n. - [fɔrk] - виделка - A2
form - n., v. - [fɔrm] - форма; формувати - A1
formal - adj. - [ˈfɔrməl] - офіційний - A2
former - adj. - [ˈfɔrmər] - колишній - B2
fortunately - adv. - [ˈfɔrtʃənɪtli] - на щастя - A2
fortune - n. - [ˈfɔrtʃən] - фортуна - B2
forty - number - [ˈfɔrti] - сорок - A1
forward - adv. - [ˈfɔrwərd], adj. - [ˈfɔrwərd] - вперед; передній - A2, B2
found - v. - [faʊnd] - знаходити - B2
four - number - [fɔr] - чотири - A1
fourteen - number - [ˌfɔrˈtin] - чотирнадцять - A1
fourth - number - [fɔrθ] - четвертий - A1
frame - n., v. - [freɪm] - рамка; рамкувати - B1
free - adj. - [fri], adv. - [fri], v. - [fri] - безкоштовний; вільно; вільнувати - A1, A2, B2
freedom - n. - [ˈfriːdəm] - свобода - B2
freeze - v. - [friːz] - замерзати - B1
frequency - n. - [ˈfriːkwənsi] - частота - B2
frequently - adv. - [ˈfriːkwəntli] - часто - B1
fresh - adj. - [frɛʃ] - свіжий - A2
Friday - n. - [ˈfraɪdeɪ] - п'ятниця - A1
fridge - n. - [frɪdʒ] - холодильник - A2
friend - n. - [frɛnd] - друг - A1
friendly - adj. - [ˈfrɛndli] - дружба; дружелюбний - A1
friendship - n. - [ˈfrɛndʃɪp] - дружба - B1
frighten - v. - [ˈfraɪtən] - лякати - B1
frightened - adj. - [ˈfraɪtənd] - напуганий - B1
frightening - adj. - [ˈfraɪtənɪŋ] - жахливий - B1
frog - n. - [frɒg] - жаба - A2
from - prep. - [frʌm] - з - A1
front - n., adj. - [frʌnt] - перед; передній - A1
frozen - adj. - [ˈfroʊzən] - заморожений - B1
fruit - n. - [fruːt] - фрукт - A1
fry - v. - [fraɪ] - смажити - B1
fuel - n. - [fjuːəl], v. - [fjuːəl] - пальне; заправляти - B1, B2
full - adj. - [fʊl] - повний - A1
fully - adv. - [ˈfʊli] - повністю - B2
fun - n. - [fʌn], adj. - [fʌn] - розвага; веселий - A1, A2
function - n. - [ˈfʌŋkʃən], v. - [ˈfʌŋkʃən] - функція; функціонувати - B1, B2
fund - n., v. - [fʌnd] - фонд; фінансувати - B2
fundamental - adj. - [ˌfʌndəˈmɛntəl] - фундаментальний - B2
funding - n. - [ˈfʌndɪŋ] - фінансування - B2
funny - adj. - [ˈfʌni] - смішний - A1
fur - n. - [fɜr] - хутро - B1
furniture - n. - [ˈfɜrnɪtʃər] - меблі - A2
further - adj. - [ˈfɜrðər], adv. - [ˈfɜrðər] - далі; додатковий - A2, B1
furthermore - adv. - [fɜrˈðərˌmɔr] - крім того - B2
future - n. - [ˈfjʊtʃər], adj. - [ˈfjʊtʃər] - майбутнє; майбутній - A1, A2
gain - v., n. - [ɡeɪn] - отримувати; виграш - B2
gallery - n. - [ˈɡæləri] - галерея - A2
game - n. - [ɡeɪm] - гра - A1
gang - n. - [ɡæŋ] - банда - B2
gap - n. - [ɡæp] - проміжок - A2
garage - n. - [ɡəˈrɑʒ] - гараж - B1
garden - n. - [ˈɡɑrdn] - сад - A1
gas - n. - [ɡæs] - газ - A2
gate - n. - [ɡeɪt] - ворота - A2
gather - v. - [ˈɡæðər] - збирати - B1
general - adj. - [ˈdʒɛnərəl] - загальний - A2
generally - adv. - [ˈdʒɛnərəli] - взагалі - B1
generate - v. - [ˈdʒɛnəˌreɪt] - генерувати - B2
generation - n. - [ˌdʒɛnəˈreɪʃən] - покоління - B1
generous - adj. - [ˈdʒɛnərəs] - щедрий - B1
genre - n. - [ʒɑn-rə] - жанр - B2
gentle - adj. - [ˈdʒɛntəl] - ніжний - B1
gentleman - n. - [ˈdʒɛntəlmən] - джентльмен - B1
geography - n. - [dʒiˈɑɡrəfi] - географія - A1
get - v. - [ɡɛt] - отримувати - A1
ghost - n. - [ɡoʊst] - привид - B1
giant - adj., n. - [ˈdʒaɪənt] - велетень; величезний - B1
gift - n. - [ɡɪft] - подарунок - A2
girl - n. - [ɡɜrl] - дівчина - A1
girlfriend - n. - [ˈɡɜrlˌfrɛnd] - подруга - A1
give - v. - [ɡɪv] - давати - A1
glad - adj. - [ɡlæd] - радий - B1
glass - n. - [ɡlæs] - скло - A1
global - adj. - [ˈɡloʊbəl] - світовий - B1
glove - n. - [ɡlʌv] - рукавичка - B1
go - v. - [ɡoʊ], n. - [ɡoʊ] - йти; піти - A1, B1
goal - n. - [ɡol] - мета - A2
god - n. - [ɡɑd] - бог - A2
gold - n., adj. - [ɡoʊld] - золото; золотий - A2
golf - n. - [ɡɔlf] - гольф - A2
good - adj. - [ɡʊd], n. - [ɡʊd] - добрий; добро - A1, A2
goodbye - exclam./n. - [ɡʊdˈbaɪ] - прощавай; прощання - A1
goods - n. - [ɡʊdz] - товари - B1
govern - v. - [ˈɡʌvərn] - керувати - B2
government - n. - [ˈɡʌvərmənt] - уряд - A2
grab - v. - [ɡræb] - хапати - B2
grade - n. - [ɡreɪd], v. - [ɡreɪd] - оцінка; оцінювати - B1, B2
gradually - adv. - [ˈɡrædʒuəli] - поступово - B2
graduate - n., v. - [ˈɡrædʒuət] - випускник; закінчувати (університет) - B1
grain - n. - [ɡreɪn] - зерно - B1
grand - adj. - [ɡrænd] - великий; прекрасний - B2
grandfather - n. - [ˈɡrændˌfɑðər] - дідусь - A1
grandmother - n. - [ˈɡrændˌmʌðər] - бабуся - A1
grandparent - n. - [ˈɡrændˌpɛrənt] - бабуся чи дідусь - A1
grant - v., n. - [ɡrænt] - надавати; грант - B2
grass - n. - [ɡræs] - трава - A2
grateful - adj. - [ˈɡreɪtfəl] - вдячний - B1
great - adj. - [ɡreɪt] - великий; чудовий - A1
green - adj., n. - [ɡriːn] - зелений; зелень - A1
greet - v. - [ɡriːt] - вітати - A2
grey - adj., n. - [ɡreɪ] - сірий - A1
ground - n. - [ɡraʊnd] - земля - A2
group - n. - [ɡruːp] - група - A1
grow - v. - [ɡroʊ] - рости - A1
growth - n. - [ɡroʊθ] - зростання - B1
guarantee - v., n. - [ˌɡærənˈti] - гарантувати; гарантія - B2
guard - n., v. - [ɡɑrd] - охорона; охороняти - B1
guess - v., n. - [ɡɛs] - вгадувати; вгадка - A1
guest - n. - [ɡɛst] - гість - A2
guide - n., v. - [ɡaɪd] - гід; вести - A2
guilty - adj. - [ˈɡɪlti] - винний - B1
guitar - n. - [ɡɪˈtɑr] - гітара - A1
gun - n. - [ɡʌn] - рушниця - A2
guy - n. - [ɡaɪ] - хлопець - A2
gym - n. - [dʒɪm] - тренажерний зал - A1
habit - n. - [ˈhæbɪt] - звичка - A2
hair - n. - [hɛr] - волосся - A1
half - n., det./pron. - [hæf], adv. - [hæf] - половина; наполовину - A1, A2
hall - n. - [hɔl] - зал - A2
hand - n. - [hænd], v. - [hænd] - рука; передавати - A1, B1
handle - v., n. - [ˈhændəl] - вмикати; ручка - B2
hang - v. - [hæŋ] - висіти - B1
happen - v. - [ˈhæpən] - траплятися - A1
happily - adv. - [ˈhæpəli] - щасливо - A2
happiness - n. - [ˈhæpɪnɪs] - щастя - B1
happy - adj. - [ˈhæpi] - щасливий - A1
hard - adj., adv. - [hɑrd] - твердий; важко - A1
hardly - adv. - [ˈhɑrdli] - мало - B1
harm - n., v. - [hɑrm] - шкода; шкодити - B2
harmful - adj. - [ˈhɑrmfəl] - шкідливий - B2
hat - n. - [hæt] - капелюх - A1
hate - v. - [heɪt], n. - [heɪt] - ненавидіти; ненависть - A1, B1
have - v. - [hæv] - мати - A1
have to - modal v. - [hæv tə] - повинен - A1
he - pron. - [hiː] - він - A1
head - n. - [hɛd], v. - [hɛd] - голова; йти вперед - A1, B1
headache - n. - [ˈhɛdˌeɪk] - головний біль - A2
headline - n. - [ˈhɛdˌlaɪn] - заголовок - B1
health - n. - [hɛlθ] - здоров'я - A1
healthy - adj. - [ˈhɛlθi] - здоровий - A1
hear - v. - [hɪr] - чути - A1
hearing - n. - [ˈhɪrɪŋ] - слух - B2
heart - n. - [hɑrt] - серце - A2
heat - n., v. - [hit] - тепло; нагрівати - A2
heating - n. - [ˈhitɪŋ] - опалення - B1
heaven - n. - [ˈhɛvən] - небо; рай - B2
heavily - adv. - [ˈhɛvəli] - сильно; важко - B1
heavy - adj. - [ˈhɛvi] - важкий - A2
heel - n. - [hil] - п'ятка - B2
height - n. - [haɪt] - висота - A2
helicopter - n. - [ˈhɛlɪˌkɑptər] - вертоліт - B1
hell - n. - [hɛl] - пекло - B2
hello - exclam./n. - [həˈloʊ] - привіт - A1
help - v., n. - [hɛlp] - допомагати; допомога - A1
helpful - adj. - [ˈhɛlpfəl] - корисний - A2
her - pron., det. - [hɜr] - її - A1
here - adv. - [hɪr] - тут - A1
hero - n. - [ˈhɪroʊ] - герой - A2
hers - pron. - [hɜrz] - її - A2
herself - pron. - [hərˈsɛlf] - сама - A2
hesitate - v. - [ˈhɛzɪˌteɪt] - сумніватися - B2
hey - exclam. - [heɪ] - ей - A1
hi - exclam. - [haɪ] - привіт - A1
hide - v. - [haɪd] - ховатися - A2
high - adj. - [haɪ] - високий; високо - A1, A2, B2
highlight - v., n. - [ˈhaɪˌlaɪt] - виділяти; освітлення - B1
highly - adv. - [ˈhaɪli] - високо - B1
hill - n. - [hɪl] - гірка - A2
him - pron. - [hɪm] - його (об'єкт) - A1
himself - pron. - [hɪmˈsɛlf] - сам - A2
hire - v., n. - [haɪr] - наймати; найм - B1, B2
his - det. - [hɪz] - його - A1
historic - adj. - [hɪsˈtɔrɪk] - історичний - B1
historical - adj. - [hɪsˈtɔrɪkəl] - історичний - B1
history - n. - [ˈhɪstəri] - історія - A1
hit - v., n. - [hɪt] - вдарити; удар - A2
hobby - n. - [ˈhɑbi] - хобі - A1
hockey - n. - [ˈhɑki] - хокей - A2
hold - v. - [hoʊld] - тримати - A2
hold - n. - [hoʊld] - тримання; утримання - B2
hole - n. - [hoʊl] - отвір - A2
holiday - n. - [ˈhɑlɪˌdeɪ] - відпустка - A1
hollow - adj. - [ˈhɑloʊ] - порожнистий - B2
holy - adj. - [ˈhoʊli] - святий - B2
home - n., adv. - [hoʊm] - дім; додому - A1
home - adj. - [hoʊm] - домашній - A2
homework - n. - [ˈhoʊmˌwɜrk] - домашнє завдання - A1
honest - adj. - [ˈɑnɪst] - чесний - B1
honour - n., v. - [ˈɒnər] - честь; шанувати - B2
hope - v. - [hoʊp] - сподіватися - A1
hope - n. - [hoʊp] - сподівання - A2
horrible - adj. - [ˈhɔrəbl] - жахливий - B1
horror - n. - [ˈhɔrər] - жах - B1
horse - n. - [hɔrs] - кінь - A1
hospital - n. - [ˈhɑspɪtl] - лікарня - A1
host - n. - [hoʊst] - господар; ведучий - B1
host - v. - [hoʊst] - приймати - B2
hot - adj. - [hɑt] - гарячий - A1
hotel - n. - [hoʊˈtɛl] - готель - A1
hour - n. - [aʊər] - година - A1
house - n. - [haʊs] - будинок - A1
house - v. - [haʊz] - давати притулок - B2
household - n. - [ˈhaʊsˌhoʊld] - домогосподарство - B2
housing - n. - [ˈhaʊzɪŋ] - житло - B2
how - adv. - [haʊ] - як - A1
however - adv. - [haʊˈɛvər] - однак; проте - A1
huge - adj. - [hjuːdʒ] - величезний - A2
human - adj., n. - [ˈhjumən] - людський; людина - A2
humorous - adj. - [ˈhjuːmərəs] - гумористичний - B2
humour - n. - [ˈhjuːmər] - гумор - B2
hundred - number - [ˈhʌndrəd] - сто - A1
hungry - adj. - [ˈhʌŋɡri] - голодний - A1
hunt - v. - [hʌnt] - полювати - B1
hunt - n. - [hʌnt] - полювання - B2
hunting - n. - [ˈhʌntɪŋ] - полювання - B2
hurricane - n. - [ˈhɜrɪˌken] - ураган - B1
hurry - n., v. - [ˈhɜri] - поспішати - B1
hurt - v. - [hɜrt] - ранити - A2
hurt - adj. - [hɜrt] - поранений - A2
hurt - n. - [hɜrt] - шкода; біль - B2
husband - n. - [ˈhʌzbənd] - чоловік; чоловік (у шлюбі) - A1
I - pron. - [aɪ] - я - A1
ice - n. - [aɪs] - лід - A1
ice cream - n. - [aɪs krim] - морозиво - A1
idea - n. - [aɪˈdiə] - ідея - A1
ideal - adj. - [aɪˈdiəl] - ідеальний - A2
ideal - n. - [aɪˈdiəl] - ідеал - B2
identify - v. - [aɪˈdɛntəˌfaɪ] - визначати - A2
identity - n. - [aɪˈdɛntəti] - ідентичність - B1
if - conj. - [ɪf] - якщо - A1
ignore - v. - [ɪɡˈnɔr] - ігнорувати - B1
ill - adj. - [ɪl] - хворий - A2
illegal - adj. - [ɪˈliːɡəl] - незаконний - B1
illness - n. - [ˈɪlnəs] - хвороба - A2
illustrate - v. - [ˈɪləˌstreɪt] - ілюструвати - B2
illustration - n. - [ˌɪləˈstreɪʃən] - ілюстрація - B2
image - n. - [ˈɪmɪdʒ] - зображення - A2
imaginary - adj. - [ɪˈmædʒɪˌnɛri] - уявний - B1
imagination - n. - [ɪˌmædʒɪˈneɪʃən] - уява - B2
imagine - v. - [ɪˈmædʒən] - уявляти - A1
immediate - adj. - [ɪˈmiːdiət] - негайний - B1
immediately - adv. - [ɪˈmiːdiətli] - негайно - A2
immigrant - n. - [ˈɪmɪɡrənt] - іммігрант - B1
impact - n., v. - [ˈɪmpækt] - вплив; удар - B1
impatient - adj. - [ɪmˈpeɪʃənt] - нетерплячий - B2
imply - v. - [ɪmˈplaɪ] - підсказувати; вказувати - B2
import - n., v. - [ˈɪmˌpɔrt] - імпорт; імпортувати - B1
importance - n. - [ɪmˈpɔrtəns] - важливість - B1
important - adj. - [ɪmˈpɔrtənt] - важливий - A1
impose - v. - [ɪmˈpoʊz] - накладати - B2
impossible - adj. - [ɪmˈpɒsəbl] - неможливий - A2
impress - v. - [ɪmˈprɛs] - вражати - B2
impressed - adj. - [ɪmˈprɛst] - вражений - B2
impression - n. - [ɪmˈprɛʃən] - враження - B1
impressive - adj. - [ɪmˈprɛsɪv] - вражаючий - B1
improve - v. - [ɪmˈpruv] - покращувати - A1
improvement - n. - [ɪmˈpruvˌmənt] - покращення - B1
in - prep., adv. - [ɪn] - в - A1
inch - n. - [ɪntʃ] - дюйм - B2
incident - n. - [ˈɪnsɪdənt] - інцидент - B2
include - v. - [ɪnˈklud] - включати - A1
included - adj. - [ɪnˈkludɪd] - включено - A2
including - prep. - [ɪnˈkludɪŋ] - включаючи - A2
income - n. - [ˈɪnkʌm] - дохід - B2
increase - v., n. - [ɪnˈkris] - збільшувати(ся); зростання - A2
increasingly - adv. - [ɪnˈkrisɪŋli] - все більше - B2
incredible - adj. - [ɪnˈkrɛdəbl] - неймовірний - A2
incredibly - adv. - [ɪnˈkrɛdəbli] - неймовірно - B1
indeed - adv. - [ɪnˈdid] - справді - B1
independent - adj. - [ˌɪndɪˈpɛndənt] - незалежний - A2
indicate - v. - [ˈɪndɪˌkeɪt] - вказувати - B1
indirect - adj. - [ˌɪndɪˈrɛkt] - непрямий - B1
individual - n., adj. - [ˌɪndəˈvɪdʒuəl] - особа; індивідуальний - A2
indoor - adj. - [ˈɪndoʊr] - критий - B1
indoors - adv. - [ɪnˈdɔrz] - всередині приміщення - B1
industrial - adj. - [ɪnˈdʌstriəl] - промисловий - B2
industry - n. - [ˈɪndəstri] - промисловість - A2
infection - n. - [ɪnˈfɛkʃən] - інфекція - B2
influence - n., v. - [ˈɪnfluəns] - вплив; впливати - B1
inform - v. - [ɪnˈfɔrm] - повідомляти - B2
informal - adj. - [ɪnˈfɔrməl] - неформальний - A2
information - n. - [ˌɪnfərˈmeɪʃən] - інформація - A1
ingredient - n. - [ɪnˈɡriːdiənt] - інгредієнт - B1
initial - adj. - [ɪˈnɪʃəl] - початковий - B2
initially - adv. - [ɪˈnɪʃəli] - спочатку - B2
initiative - n. - [ɪˈnɪʃətɪv] - ініціатива - B2
injure - v. - [ˈɪndʒər] - травмувати - B1
injured - adj. - [ˈɪndʒərd] - постраждалий - B1
injury - n. - [ˈɪndʒəri] - травма - A2
inner - adj. - [ˈɪnər] - внутрішній - B2
innocent - adj. - [ˈɪnəsənt] - невинний - B1
insect - n. - [ˈɪnsɛkt] - комаха - A2
inside - prep., adv., n., adj. - [ɪnˈsaɪd] - всередині - A2
insight - n. - [ˈɪnsaɪt] - проникливість - B2
insist - v. - [ɪnˈsɪst] - наполягати - B2
inspire - v. - [ɪnˈspaɪər] - надихати - B2
install - v. - [ɪnˈstɔl] - встановлювати - B2
instance - n. - [ˈɪnstəns] - приклад - B2
instead - adv. - [ɪnˈstɛd] - замість цього - A2
institute - n. - [ˈɪnstɪˌtut] - інститут - B2
institution - n. - [ˌɪnstəˈtuʃən] - установа - B2
instruction - n. - [ɪnˈstrʌkʃən] - інструкція - A2
instructor - n. - [ɪnˈstrʌktər] - інструктор - A2
instrument - n. - [ˈɪnstrəmənt] - інструмент - A2
insurance - n. - [ɪnˈʃʊrəns] - страхування - B2
intelligence - n. - [ɪnˈtɛlɪdʒəns] - розум - B1
intelligent - adj. - [ɪnˈtɛlɪdʒənt] - розумний - A2
intend - v. - [ɪnˈtɛnd] - мати намір - B1
intended - adj. - [ɪnˈtɛndɪd] - призначений - B2
intense - adj. - [ɪnˈtɛns] - інтенсивний - B2
intention - n. - [ɪnˈtɛnʃən] - намір - B1
interest - n., v. - [ˈɪntrɪst] - інтерес; цікавити - A1
interested - adj. - [ˈɪntrɪstɪd] - зацікавлений - A1
interesting - adj. - [ˈɪntrɪstɪŋ] - цікавий - A1
internal - adj. - [ɪnˈtɜrnəl] - внутрішній - B2
international - adj. - [ˌɪntəˈnæʃənl] - міжнародний - A2
internet - n. - [ˈɪntərˌnɛt] - Інтернет - A1
interpret - v. - [ɪnˈtɜrprɪt] - тлумачити - B2
interrupt - v. - [ˌɪntəˈrʌpt] - переривати - B2
interview - n., v. - [ˈɪntərvjuː] - інтерв'ю; брати інтерв'ю - A1
into - prep. - [ˈɪntu] - в - A1
introduce - v. - [ˌɪntrəˈdjuːs] - представляти - A1
introduction - n. - [ˌɪntrəˈdʌkʃən] - вступ - A2
invent - v. - [ɪnˈvɛnt] - винаходити - A2
invention - n. - [ɪnˈvɛnʃən] - винахід - A2
invest - v. - [ɪnˈvɛst] - інвестувати - B1
investigate - v. - [ɪnˈvɛstɪˌɡeɪt] - розслідувати - B1
investigation - n. - [ɪnˌvɛstɪˈɡeɪʃən] - розслідування - B2
investment - n. - [ɪnˈvɛstmənt] - інвестиція - B2
invitation - n. - [ˌɪnvɪˈteɪʃən] - запрошення - A2
invite - v. - [ɪnˈvaɪt] - запрошувати - A2
involve - v. - [ɪnˈvɑlv] - включати - A2
involved - adj. - [ɪnˈvɑlvd] - залучений - B1
iron - n., v. - [ˈaɪərn] - залізо; праска - B1
island - n. - [ˈaɪlənd] - острів - A1
issue - n., v. - [ˈɪʃuː] - питання; видача - B1
IT - n. - [aɪˈtiː] - ІТ - B1
it - pron. - [ɪt] - воно - A1
item - n. - [ˈaɪtəm] - пункт - A2
its - det. - [ɪts] - його, її, його (про предмети або тварин) - A1
itself - pron. - [ɪtˈsɛlf] - сам - A2
jacket - n. - [ˈdʒækɪt] - куртка - A1
jam - n. - [dʒæm] - варення - A2
January - n. - [ˈdʒænjuˌɛri] - січень - A1
jazz - n. - [dʒæz] - джаз - A2
jeans - n. - [dʒinz] - джинси - A1
jewellery - n. - [ˈʤʊəlri] - прикраси - A2
job - n. - [ʤɑb] - робота - A1
join - v. - [ʤɔɪn] - приєднуватися - A1
joke - n., v. - [ʤoʊk] - жарт; шуткувати - A2
journal - n. - [ˈʤɜːrnəl] - журнал - B1
journalist - n. - [ˈʤɜːrnəlɪst] - журналіст - A2
journey - n. - [ˈʤɜːrni] - подорож - A1
joy - n. - [ʤɔɪ] - радість - B2
judge - n., v. - [ʤʌdʒ] - суддя; судити - B1
judgement - n. - [ˈʤʌdʒmənt] - розсуд - B2
juice - n. - [ʤus] - сік - A1
July - n. - [ʤʊˈlaɪ] - липень - A1
jump - v., n. - [ʤʌmp] - стрибати; стрибок - A2
June - n. - [dʒuːn] - червень - A1
junior - adj. - [ˈdʒuː.njər] - молодший - B2
just - adv. - [dʒʌst] - просто - A1
justice - n. - [ˈdʒʌs.tɪs] - правосуддя - B2
justify - v. - [ˈdʒʌs.tɪ.faɪ] - виправдовувати - B2
keen - adj. - [kiːn] - зацікавлений - B1
keep - v. - [kiːp] - утримувати - A1
key - n. - [kiː], adj. - [kiː], v. - [kiː] - ключ, ключовий, клавіша - A1, B1
keyboard - n. - [ˈkiː.bɔːrd] - клавіатура - B1
kick - v., n. - [kɪk] - лягати, удар / удар - B1
kid - n. - [kɪd] - дитина - A2
kill - v. - [kɪl] - вбивати - A2
killing - n. - [ˈkɪlɪŋ] - вбивство - B1
kilometre - n. - [ˈkɪl.ə.miː.t̬ɚ] - кілометр - A1
kind (type) - n. - [kaɪnd] - вид - A1
kind (caring) - adj. - [kaɪnd] - люб'язний - B1
king - n. - [kɪŋ] - король - A2
kiss - v., n. - [kɪs] - цілунок, цілувати - B1
kitchen - n. - [ˈkɪtʃ.ɪn] - кухня - A1
knee - n. - [ni] - коліно - A2
knife - n. - [naɪf] - ніж - A2
knock - v., n. - [nɑːk] - стукати, стук - A2, B1
know - v. - [noʊ] - знати - A1
knowledge - n. - [ˈnɒl.ɪdʒ] - знання - A2
lab - n. - [læb] - лабораторія - A2
label - n., v. - [ˈleɪ.bəl] - етикетка, позначати - B1
laboratory - n. - [ˈlæb.rə.tɔːr.i] - лабораторія - B1
labour - n. - [ˈleɪ.bər] - праця - B2
lack - n., v. - [læk] - відсутність, не мати чогось - B1
lady - n. - [ˈleɪ.di] - леді, пані - A2
lake - n. - [leɪk] - озеро - A2
lamp - n. - [læmp] - лампа - A2
land - n. - [lænd], v. - [lænd] - земля, приземлятися - A1, A2
landscape - n. - [ˈlænd.skeɪp] - ландшафт - B2
language - n. - [ˈlæŋ.ɡwɪdʒ] - мова - A1
laptop - n. - [ˈlæp.tɑːp] - ноутбук - A2
large - adj. - [lɑːrdʒ] - великий - A1
largely - adv. - [ˈlɑːrdʒ.li] - в основному - B2
last1 (final) - det. - [læst], adv., n. - [læst] - останній - A1, A2
last1 (taking time) - v. - [læst] - тривати - A2
late - adj., adv. - [leɪt] - пізній, пізно - A1
later - adv. - [ˈleɪ.t̬ɚ] - пізніше - A1, adj. - [ˈleɪ.t̬ɚ] - наступний, пізніший - A2
latest - adj. - [ˈleɪ.t̬ɪst] - останній - B1, n. - [ˈleɪ.t̬ɪst] - найновіший - B2
laugh - v., n. - [læf] - сміятися, сміх - A1
laughter - n. - [ˈlæf.t̬ɚ] - сміх - A2
launch - v., n. - [lɔːntʃ] - запускати, запуск - B2
law - n. - [lɔː] - закон - A2
lawyer - n. - [ˈlɔɪər] - адвокат - A2
lay - v. - [leɪ] - класти - B1
layer - n. - [ˈleɪ.ər] - шар - B1
lazy - adj. - [ˈleɪzi] - лінивий - A2
lead1 - v. - [liːd], n. - [liːd] - вести, свинець - A2, B1
leader - n. - [ˈliː.dɚ] - лідер - A2
leadership - n. - [ˈliː.dɚ.ʃɪp] - лідерство - B2
leading - adj. - [ˈliː.dɪŋ] - провідний - B1
leaf - n. - [liːf] - листок - B1
league - n. - [liːɡ] - ліга - B2
lean - v. - [liːn] - нахилятися - B2
learn - v. - [lɜːrn] - вчитися - A1
learning - n. - [ˈlɜːrnɪŋ] - навчання - A2
least - det./pron., adv. - [liːst] - найменше - A2
leather - n. - [ˈleð.ɚ] - шкіра - B1
leave - v. - [liːv], n. - [liːv] - залишати, листя - A1, B2
lecture - n., v. - [ˈlek.tʃɚ] - лекція, лекціонувати - A2
left - adj., adv., n. - [left] - лівий, залишений - A1
leg - n. - [leɡ] - нога - A1
legal - adj. - [ˈliː.ɡəl] - юридичний - B1
leisure - n. - [ˈliː.ʒɚ] - дозвілля - B1
lemon - n. - [ˈlem.ən] - лимон - A2
lend - v. - [lend] - позичати - A2
length - n. - [leŋkθ] - довжина - B1
less - det./pron., adv. - [les] - менше - A2
lesson - n. - [ˈles.ən] - урок - A1
let - v. - [let] - дозволяти - A1
letter - n. - [ˈlet.ɚ] - лист - A1
level - n. - [ˈlev.əl], adj. - [ˈlev.əl], v. - [ˈlev.əl] - рівень, рівний, рівняти - A2, B1, B2
library - n. - [ˈlaɪ.brer.i] - бібліотека - A1
licence - n. - [ˈlaɪ.səns] - ліцензія - B2
lie1 - v. - [laɪ] - лежати - A1
lie2 (tell a lie) - v., n. - [laɪ] - брехати, брехня - B1
life - n. - [laɪf] - життя - A1
lifestyle - n. - [ˈlaɪf.staɪl] - стиль життя - A2
lift - v., n. - [lɪft] - піднімати, ліфт - A2
light (from the sun/a lamp) - n., adj. - [laɪt], v. - [laɪt] - світло, світлий, запалювати - A1, A2
light (not heavy) - adj. - [laɪt] - легкий - A2
like (similar) - prep. - [laɪk] - як - A1
like (find sb/sth pleasant) - v. - [laɪk], n. - [laɪk] - подобатися, схожий - A1, B1
likely - adj. - [ˈlaɪk.li] - ймовірний - A2
limit - n., v. - [ˈlɪm.ɪt] - обмеження, обмежувати - B1
limited - adj. - [ˈlɪm.ɪ.tɪd] - обмежений - B2
line - n. - [laɪn], v. - [laɪn] - лінія, лініювати - A1, B2
link - n., v. - [lɪŋk] - зв'язок, посилання - A2
lion - n. - [ˈlaɪ.ən] - лев - A1
lip - n. - [lɪp] - губа - B1
liquid - n., adj. - [ˈlɪk.wɪd] - рідина, рідкий - B1
list - n., v. - [lɪst] - список, включати в список - A1
listen - v. - [ˈlɪs.ən] - слухати - A1
listener - n. - [ˈlɪs.ən.ɚ] - слухач - A2
literature - n. - [ˈlɪt̬.ɚ.ə.tʃʊr] - література - B1
little - adj., det./pron. - [ˈlɪt̬.əl], adv. - [ˈlɪt̬.əl] - мало, малий - A1, A2
live1 - v. - [lɪv] - жити - A1
live2 - adj., adv. - [laɪv] - живий, живо - B1
lively - adj. - [ˈlaɪv.li] - жвавий - B2
living - adj., n. - [ˈlɪv.ɪŋ] - живий, життя - B1
load - n., v. - [loʊd] - навантаження, завантажувати - B2
loan - n. - [loʊn] - позика - B2
local - adj. - [ˈloʊ.kəl], n. - [ˈloʊ.kəl] - місцевий, місцевість - A1, B1
locate - v. - [loʊˈkeɪt] - розташовувати - B1
located - adj. - [ˈloʊ.keɪ.tɪd] - розташований - B1
location - n. - [loʊˈkeɪ.ʃən] - місце розташування - B1
lock - v., n. - [lɑːk] - закривати, замок - A2
logical - adj. - [ˈlɑː.dʒɪ.kəl] - логічний - B2
lonely - adj. - [ˈloʊn.li] - самотній - B1
long1 - adj., adv. - [lɔːŋ] - довгий, довго - A1
long-term - adj., adv. - [ˌlɔːŋˈtɜːrm] - довгостроковий - B2
look - v. - [lʊk] - дивитися - A1
loose - adj. - [luːs] - вільний - B2
lord - n. - [lɔːrd] - лорд - B2
lorry - n. - [ˈlɒr.i] - вантажівка - A2
lose - v. - [luːz] - втрачати - A1
loss - n. - [lɔːs] - втрата - B1
lost - adj. - [lɒst] - втрачений - A2
lot - pron., det., adv. - [lɑːt] - багато - A1
loud - adj., adv. - [laʊd] - голосний, голосно - A2
loudly - adv. - [ˈlaʊd.li] - голосно - A2
love - n., v. - [lʌv] - любов, любити - A1
lovely - adj. - [ˈlʌv.li] - чудовий - A2
low - adj., adv. - [loʊ], n. - [loʊ] - низький, низько - A2, B2
lower - v. - [ˈloʊ.ɚ] - знижувати - B2
luck - n. - [lʌk] - удача - A2
lucky - adj. - [ˈlʌk.i] - удачливий - A2
lunch - n. - [lʌntʃ] - обід - A1
lung - n. - [lʌŋ] - легеня - B2
luxury - n. - [ˈlʌkʒ.ər.i] - розкіш - B1
machine - n. - [məˈʃiːn] - машина - A1
mad - adj. - [mæd] - божевільний - B1
magazine - n. - [ˌmæɡ.əˈziːn] - журнал - A1
magic - n., adj. - [ˈmædʒ.ɪk] - магія, магічний - B1
mail - n., v. - [meɪl] - пошта, відправляти поштою - A2
main - adj. - [meɪn] - основний - A1
mainly - adv. - [ˈmeɪn.li] - головним чином - B1
maintain - v. - [meɪnˈteɪn] - підтримувати - B2
major - adj. - [ˈmeɪ.dʒɚ] - великий, основний - A2
majority - n. - [məˈdʒɔːr.ə.t̬i] - більшість - B2
make - v. - [meɪk] - робити - A1, n. - [meɪk] - створювати - B2
male - adj., n. - [meɪl] - чоловічий, чоловік - A2
mall - n. - [mɑːl] - торговий центр - B1
man - n. - [mæn] - чоловік - A1
manage - v. - [ˈmæn.ɪdʒ] - керувати - A2
management - n. - [ˈmæn.ɪdʒ.mənt] - управління - B1
manager - n. - [ˈmæn.ɪdʒ.ɚ] - менеджер - A2
manner - n. - [ˈmæn.ɚ] - спосіб, манера - A2
many - det./pron. - [ˈmen.i] - багато - A1
map - n. - [mæp], v. - [mæp] - карта, картографувати - A1, B2
March - n. - [mɑːrtʃ] - березень - A1
mark - v., n. - [mɑːrk] - позначати, оцінка - A2
market - n. - [ˈmɑːr.kɪt], v. - [ˈmɑːr.kɪt] - ринок, реалізувати - A1, B1
marketing - n. - [ˈmɑːr.kɪt.ɪŋ] - маркетинг - B1
marriage - n. - [ˈmær.ɪdʒ] - шлюб - B1
married - adj. - [ˈmær.id] - одружений - A1
marry - v. - [ˈmer.i] - одружуватися - A2
mass - n., adj. - [mæs] - маса, масовий - B2
massive - adj. - [ˈmæs.ɪv] - масивний - B2
master - n., v. - [ˈmæs.tɚ] - майстер, володарювати - B2
match (contest/correspond) - n., v. - [mætʃ] - матч, відповідати - A1
matching - adj. - [ˈmætʃɪŋ] - відповідний - B2
material - n., adj. - [məˈtɪə.ri.əl], [məˈtɪr.i.əl] - матеріал, матеріальний - A2, B2
mathematics - n. - [ˌmæθ.əˈmæt̬.ɪks] - математика - A2
maths - n. - [mæθs] - математика - A2
matter - n., v. - [ˈmæt̬.ɚ] - справа, мати значення - A2
maximum - adj., n. - [ˈmæk.sɪ.məm] - максимальний, максимум - B2
May - n. - [meɪ] - травень - A1
may - modal v. - [meɪ] - може - A2
maybe - adv. - [ˈmeɪ.bi] - можливо - A1
me - pron. - [miː] - мене - A1
meal - n. - [miːl] - їжа - A1
mean - v. - [miːn] - означати - A1
meaning - n. - [ˈmiː.nɪŋ] - значення - A1
means - n. - [miːnz] - засіб - B2
meanwhile - adv. - [ˌmiːn.ˈwaɪl] - тим часом - B1
measure - v., n. - [ˈmɛʒ.ɚ] - вимірювати, міра - B1
measurement - n. - [ˈmɛʒ.ər.mənt] - вимірювання - B2
meat - n. - [miːt] - м'ясо - A1
media - n. - [ˈmiː.di.ə] - медіа - A2
medical - adj. - [ˈmɛd.ɪ.kəl] - медичний - A2
medicine - n. - [ˈmɛd.ɪ.sɪn] - медицина - A2
medium - adj. - [ˈmiː.di.əm], n. - [ˈmiː.di.əm] - середній, середовище - B1, B2
meet - v. - [miːt] - зустрічатися - A1
meeting - n. - [ˈmiː.tɪŋ] - зустріч - A1
melt - v. - [mɛlt] - танути - B2
member - n. - [ˈmɛm.bɚ] - член - A1
memory - n. - [ˈmɛm.ə.ri] - пам'ять - A2
mental - adj. - [ˈmɛn.t̬əl] - розумовий - B1
mention - v. - [ˈmɛn.ʃən], n. - [ˈmɛn.ʃən] - згадувати, згадка - A2, B1
menu - n. - [ˈmɛn.juː] - меню - A1
mess - n., v. - [mɛs] - беспорядок, псувати - B1
message - n. - [ˈmɛs.ɪdʒ] - повідомлення - A1
metal - n. - [ˈmɛt̬.əl] - метал - A2
method - n. - [ˈmɛθ.əd] - метод - A2
metre - n. - [ˈmiː.t̬ɚ] - метр - A1
middle - n., adj. - [ˈmɪd.əl] - середина, середній - A2
midnight - n. - [ˈmɪd.naɪt] - північ - A1
might - modal v. - [maɪt] - може бути - A2
mild - adj. - [maɪld] - помірний - B1
mile - n. - [maɪl] - миля - A1
military - adj., n. - [ˈmɪl.ɪ.ter.i] - військовий, військові - B2
milk - n. - [mɪlk] - молоко - A1
million - number - [ˈmɪl.jən] - мільйон - A1
mind - n., v. - [maɪnd] - розум, бути обізнаним - A2
mine (belongs to me) - pron. - [maɪn] - мій - A2
mine (hole in the ground) - n. - [maɪn] - рудник - B1
mineral - n. - [ˈmɪn.ər.əl] - мінерал - B2
minimum - adj., n. - [ˈmɪn.ə.məm] - мінімальний, мінімум - B2
minister - n. - [ˈmɪn.ɪ.stɚ] - міністр - B2
minor - adj. - [ˈmaɪ.nɚ] - неповнолітній - B2
minority - n. - [maɪˈnɒr.ə.ti] - менший за кількістю - B2
minute1 - n. - [ˈmɪn.ɪt] - хвилина - A1
mirror - n. - [ˈmɪr.ɚ] - дзеркало - A2
miss - v. - [mɪs] - пропустити - A1
missing - adj. - [ˈmɪs.ɪŋ] - відсутній - A2
mission - n. - [ˈmɪʃ.ən] - місія - B2
mistake - n. - [mɪˈsteɪk], v. - [mɪˈsteɪk] - помилка, помилятися - A1, B2
mix - v., n. - [mɪks] - змішувати, суміш - B1
mixed - adj. - [mɪkst] - змішаний - B2
mixture - n. - [ˈmɪkstʃɚ] - суміш - B1
mobile - adj., n. - [ˈmoʊ.bəl] - мобільний, мобільний телефон - A2
model - n. - [ˈmɑː.dəl], v. - [ˈmɑː.dəl] - модель, моделювати - A1, B2
modern - adj. - [ˈmɑː.dɚn] - сучасний - A1
modify - v. - [ˈmɑː.dɪ.faɪ] - модифікувати - B2
moment - n. - [ˈmoʊ.mənt] - момент - A1
Monday - n. - [ˈmʌn.deɪ] - понеділок - A1
money - n. - [ˈmʌn.i] - гроші - A1
monitor - n., v. - [ˈmɑː.nɪ.t̬ɚ] - монітор, контролювати - B2
monkey - n. - [ˈmʌŋ.ki] - мавпа - A2
month - n. - [mʌnθ] - місяць - A1
mood - n. - [muːd] - настрій - B1
moon - n. - [muːn] - місяць - A2
moral - adj., n. - [ˈmɔːr.əl] - моральний, мораль - B2
more - det./pron., adv. - [mɔːr] - більше - A1
morning - n. - [ˈmɔːr.nɪŋ] - ранок - A1
most - det./pron., adv. - [moʊst] - більшість, найбільше - A1
mostly - adv. - [ˈmoʊst.li] - в основному - A2
mother - n. - [ˈmʌð.ər] - мати - A1
motor - n., adj. - [ˈmoʊ.t̬ɚ] - двигун, моторний - B2
motorcycle - n. - [ˈmoʊ.t̬ərˌsaɪ.kəl] - мотоцикл - A2
mount - v. - [maʊnt] - монтувати - B2
mountain - n. - [ˈmaʊn.t̬ən] - гора - A1
mouse - n. - [maʊs] - миша - A1
mouth - n. - [maʊθ] - рот - A1
move - v. - [muːv], n. - [muːv] - рухатися, рух - A1, B1
movement - n. - [ˈmuːv.mənt] - рух - A2
movie - n. - [ˈmuː.vi] - фільм - A1
much - det./pron., adv. - [mʌtʃ] - багато - A1
mud - n. - [mʌd] - бруд - B1
multiple - adj. - [ˈmʌl.tɪ.pl̩] - множинний - B2
multiply - v. - [ˈmʌl.tɪ.plaɪ] - множити - B2
mum - n. - [mʌm] - мама - A1
murder - n., v. - [ˈmɝː.dɚ] - вбивство, вбивати - B1
muscle - n. - [ˈmʌs.əl] - м'яз - B1
museum - n. - [mjuːˈziː.əm] - музей - A1
music - n. - [ˈmjuː.zɪk] - музика - A1
musical - adj. - [ˈmjuː.zɪ.kəl], n. - [ˈmjuː.zɪ.kəl] - музичний, мюзикл - A2, B1
musician - n. - [mjuːˈzɪʃ.ən] - музикант - A2
must - modal v. - [mʌst] - повинен - A1
my - det. - [maɪ] - мій - A1
myself - pron. - [maɪˈself] - себе - A2
mysterious - adj. - [mɪˈstɪr.i.əs] - таємничий - B2
mystery - n. - [ˈmɪs.tər.i] - загадка - B1
nail - n. - [neɪl] - цвях - B1
name - n., v. - [neɪm] - ім'я, називати - A1
narrative - n., adj. - [ˈnær.ə.tɪv] - наратив, наративний - B1
narrow - adj. - [ˈnæroʊ], v. - [ˈnæroʊ] - вузький, звузити - A2, B2
nation - n. - [ˈneɪ.ʃən] - нація - B1
national - adj. - [ˈnæʃ.ənl] - національний - A2, B2
native - adj., n. - [ˈneɪ.tɪv] - рідний, корінний - B1
natural - adj. - [ˈnætʃ.ər.əl] - природний - A1
naturally - adv. - [ˈnætʃ.ər.ə.li] - природно - B1
nature - n. - [ˈneɪ.tʃər] - природа - A2
near - prep., adj., adv. - [nɪr] - близько, біля - A1
nearly - adv. - [ˈnɪr.li] - майже - A2
neat - adj. - [niːt] - охайний - B2
necessarily - adv. - [ˌnes.əˈser.əl.i] - обов'язково - B1
necessary - adj. - [ˈnes.əˌser.i] - необхідний - A2
neck - n. - [nek] - шия - A2
need - v. - [niːd], n. - [niːd], modal v. - [niːd] - потрібно, потреба - A1, A2, B1
needle - n. - [ˈniː.dəl] - голка - B1
negative - adj. - [ˈneg.ə.tɪv], n. - [ˈneg.ə.t̬ɪv] - негативний, відмінний - A1, B2
neighbour - n. - [ˈneɪ.bɚ] - сусід - A1
neighbourhood - n. - [ˈneɪ.bɚ.hʊd] - район, сусідство - B1
neither - det./pron. - [ˈniː.ðɚ], adv. - [ˈniː.ðɚ] - ані один, ні - A2, B1
nerve - n. - [nɜːrv] - нерв - B2
nervous - adj. - [ˈnɜːrvəs] - нервовий - A2
net - n. - [net] - мережа - B1
network - n. - [ˈnet.wɜːrk] - мережа - A2
never - adv. - [ˈnev.ɚ] - ніколи - A1
nevertheless - adv. - [ˌnev.ər.ðəˈles] - тим не менше - B2
new - adj. - [nuː] - новий - A1
news - n. - [nuːz] - новини - A1
newspaper - n. - [ˈnuːzˌpeɪ.pɚ] - газета - A1
next - adj., adv. - [nekst], n. - [nekst] - наступний - A1, B1
next to - prep. - [nekst tə] - поруч із - A1
nice - adj. - [naɪs] - приємний - A1
night - n. - [naɪt] - ніч - A1
nightmare - n. - [ˈnaɪt.mer] - кошмар - B2
nine - number - [naɪn] - дев'ять - A1
nineteen - number - [ˌnaɪnˈtiːn] - дев'ятнадцять - A1
ninety - number - [ˈnaɪn.ti] - дев'яносто - A1
no - exclam., det. - [noʊ] - ні - A1
no one - pron. - [noʊ wʌn] - ніхто - A1
nobody - pron. - [ˈnoʊ.bɑː.di] - ніхто - A1
noise - n. - [nɔɪz] - шум - A2
noisy - adj. - [ˈnɔɪ.zi] - шумний - A2
none - pron. - [nʌn] - ніхто, ніщо - A2
nor - conj./adv. - [nɔːr] - ані, ні - B1
normal - adj. - [ˈnɔːr.məl] - нормальний - A2
normally - adv. - [ˈnɔːr.məl.i] - зазвичай - A2
north - n., adj., adv. - [nɔːrθ] - північ, північний - A1
northern - adj. - [ˈnɔːr.ðərn] - північний - B1
nose - n. - [noʊz] - ніс - A1
not - adv. - [nɑːt] - не - A1
note - n. - [noʊt], v. - [noʊt] - примітка, зауваження - A1, B1
nothing - pron. - [ˈnʌθ.ɪŋ] - нічого - A1
notice - v., n. - [ˈnoʊ.t̬ɪs] - помічати, повідомлення - A2
notion - n. - [ˈnoʊ.ʃən] - уявлення - B2
novel - n. - [ˈnɑː.vəl] - роман - A2
November - n. - [noʊˈvem.bɚ] - листопад - A1
now - adv. - [naʊ] - зараз - A1
nowhere - adv. - [ˈnoʊ.weər] - ніде - A2
nuclear - adj. - [ˈnuː.kli.ɚ] - ядерний - B1
number - n. - [ˈnʌm.bɚ], v. - [ˈnʌm.bɚ] - номер, число - A1, A2
numerous - adj. - [ˈnuː.mər.əs] - численний - B2
nurse - n. - [nɝːs] - медсестра - A1
nut - n. - [nʌt] - горіх - A2
obey - v. - [oʊˈbeɪ] - слухати - B2
object - n. - [ˈɑːb.dʒɪkt], v. - [əbˈdʒekt] - об'єкт, протестувати - A1, B2
objective - n., adj. - [əbˈdʒek.tɪv] - об'єктив, об'єктивний - B2
obligation - n. - [ˌɑː.bl̩.ɪˈɡeɪ.ʃən] - обов'язок - B2
observation - n. - [ˌɑːb.zərˈveɪ.ʃən] - спостереження - B2
observe - v. - [əbˈzɝːv] - спостерігати - B2
obtain - v. - [əbˈteɪn] - отримувати - B2
obvious - adj. - [ˈɑːb.vi.əs] - очевидний - B1
obviously - adv. - [ˈɑːb.vi.əs.li] - очевидно - B1
occasion - n. - [əˈkeɪ.ʒən] - випадок - B1
occasionally - adv. - [əˈkeɪ.ʒən.əl.i] - іноді - B2
occur - v. - [əˈkɝː] - траплятися - B1
ocean - n. - [ˈoʊ.ʃən] - океан - A2
o'clock - adv. - [əˈklɑːk] - година - A1
October - n. - [ɑːkˈtoʊ.bɚ] - жовтень - A1
odd - adj. - [ɑːd] - дивний - B1
of - prep. - [əv] - з, від - A1
off - adv., prep. - [ɔːf] - від, відключений - A1
offence - n. - [əˈfens] - порушення - B2
offend - v. - [əˈfend] - ображати - B2
offensive - adj. - [əˈfensɪv] - образливий - B2
offer - v., n. - [ˈɑː.fɚ] - пропонувати, пропозиція - A2
office - n. - [ˈɑː.fɪs] - офіс - A1
officer - n. - [ˈɑː.fɪs.ɚ] - офіцер - A2
official - adj. - [əˈfɪʃ.əl], n. - [əˈfɪʃ.əl] - офіційний, посадовець - B1, B2
often - adv. - [ˈɔː.fn̩] - часто - A1
oh - exclam. - [oʊ] - ох - A1
oil - n. - [ɔɪl] - олія - A2
OK - exclam., adj./adv. - [ˌoʊˈkeɪ] - добре, все гаразд - A1
old - adj. - [oʊld] - старий - A1
old-fashioned - adj. - [ˌoʊldˈfæʃ.ənd] - застарілий - B1
on - prep., adv. - [ɑːn] - на - A1
once - adv. - [wʌns], conj. - [wʌns] - одного разу, як тільки - A1, B1
one - number/det., pron. - [wʌn] - один - A1
onion - n. - [ˈʌn.jən] - цибуля - A1
online - adj., adv. - [ˈɑːn.laɪn] - в мережі, онлайн - A1
only - adj., adv. - [ˈoʊn.li] - тільки, лише - A1
onto - prep. - [ˈɑːn.tuː] - на - A2
open - adj., v. - [ˈoʊ.pən] - відкритий, відкривати - A1
opening - n. - [ˈoʊ.pənɪŋ] - відкриття - B2
operate - v. - [ˈɑː.pə.reɪt] - працювати, проводити операцію - B2
operation - n. - [ˌɑː.pəˈreɪ.ʃən] - операція - B1
opinion - n. - [əˈpɪn.jən] - думка - A1
opponent - n. - [əˈpoʊ.nənt] - супротивник - B2
opportunity - n. - [ˌɑː.pɚˈtuː.nə.t̬i] - можливість - A2
oppose - v. - [əˈpoʊz] - протиставлятися - B2
opposed - adj. - [əˈpoʊzd] - протилежний - B2
opposite - adj., adv., prep., n. - [ˈɑː.pə.zɪt] - протилежний, навпроти - A1
opposition - n. - [ˌɑː.pəˈzɪʃ.ən] - опозиція - B2
option - n. - [ˈɑːp.ʃən] - варіант - A2
or - conj. - [ɔːr] - або - A1
orange - n., adj. - [ˈɔːr.ɪndʒ] - апельсин, оранжевий - A1
order - n., v. - [ˈɔːr.dɚ] - порядок, замовляти - A1
ordinary - adj. - [ˈɔːr.dəˌner.i] - звичайний - A2
organ - n. - [ˈɔːr.ɡən] - орган - B2
organization - n. - [ˌɔːr.ɡə.nəˈzeɪ.ʃən] - організація - A2
organize - v. - [ˈɔːr.ɡən.aɪz] - організовувати - A2
organized - adj. - [ˈɔːr.ɡən.aɪzd] - організований - B1
organizer - n. - [ˈɔːr.ɡən.aɪz.ɚ] - організатор - B1
origin - n. - [ˈɔːr.ɪ.dʒɪn] - походження - B2
original - adj. - [əˈrɪdʒ.ənl], n. - [əˈrɪdʒ.ənl] - оригінальний, оригінал - A2, B1
originally - adv. - [əˈrɪdʒ.ən.əl.i] - спочатку, по-перше - B1
other - adj./pron. - [ˈʌð.ɚ] - інший - A1
otherwise - adv. - [ˈʌð.ɚˌwaɪz] - інакше - B2
ought - modal v. - [ɔːt] - слід - B1
our - det. - [aʊɚ] - наш - A1
ours - pron. - [aʊrz] - наш - B1
ourselves - pron. - [aʊrˈselvz] - себе - A2
out - adv./prep. - [aʊt] - зовсім, назовні - A1
outcome - n. - [ˈaʊt.kʌm] - результат - B2
outdoor - adj. - [ˈaʊt.dɔːr] - на вулиці - B1
outdoors - adv. - [ˈaʊt.dɔːrz] - на вулиці - B1
outer - adj. - [ˈaʊ.t̬ɚ] - зовнішній - B2
outline - n., v. - [ˈaʊt.laɪn] - контур, намет - B2
outside - adv. A1, prep., noun., adj. A2 - [ˈaʊt.saɪd] - зовні, ззовні, зовнішній - A1, A2
oven - n. - [ˈʌv.ən] - духовка - A2
over - prep., adv. - [ˈoʊ.vɚ] - над, понад, закінчений - A1
overall - adj., adv. - [ˌoʊ.vɚˈɑːl] - загальний, в цілому - B2
owe - v. - [oʊ] - бути зобов'язаним - B2
own - adj./pron. A1, v. A2 - [oʊn] - власний, володіти - A1, A2
owner - n. - [ˈoʊ.nɚ] - власник - A2
pace - n., v. - [peɪs] - швидкість, темп - B2
pack - v. A2, n. B1 - [pæk] - упаковувати, пачка - A2, B1
package - n. B1, v. B2 - [ˈpæk.ɪdʒ] - пакет, упаковувати - B1, B2
page - n. - [peɪdʒ] - сторінка - A1
pain - n. - [peɪn] - біль - A2
painful - adj. - [ˈpeɪn.fəl] - болісний - B1
paint - v., n. - [peɪnt] - фарбувати, фарба - A1
painter - n. - [ˈpeɪn.t̬ɚ] - художник - A2
painting - n. - [ˈpeɪn.t̬ɪŋ] - живопис - A1
pair - n. - [per] - пара - A1
palace - n. - [ˈpæl.ɪs] - палац - A2
pale - adj. - [peɪl] - блідий - B1
pan - n. - [pæn] - кастрюля - B1
panel - n. - [ˈpæn.əl] - панель, комітет - B2
pants - n. - [pænts] - штани - A2
paper - n. - [ˈpeɪ.pɚ] - папір - A1
paragraph - n. - [ˈpær.ə.ɡræf] - абзац - A1
parent - n. - [ˈper.ənt] - батько, мати - A1
park - n., v. - [pɑːrk] - парк, паркувати - A1
parking - n. - [ˈpɑːrkɪŋ] - паркування - A2
parliament - n. - [ˈpɑːr.lə.mənt] - парламент - B2
part - n. - [pɑːrt] - частина - A1
participant - n. - [pɑːrˈtɪs.ɪ.pənt] - учасник - B2
participate - v. - [pɑːrˈtɪs.ɪ.peɪt] - брати участь - B1
particular - adj. - [pɑːrˈtɪk.jə.lɚ] - конкретний - A2
particularly - adv. - [pɑːrˈtɪk.jə.lɚ.li] - особливо - B1
partly - adv. - [ˈpɑːrt.li] - частково - B2
partner - n. - [ˈpɑːrt.nɚ] - партнер - A1
party - n. - [ˈpɑːrt.i] - вечірка, партія - A1
pass - v. A2, n. B1 - [pæs] - проходити, пропуск - A2, B1
passage - n. - [ˈpæs.ɪdʒ] - прохід - B2
passenger - n. - [ˈpæs.ən.dʒɚ] - пасажир - A2
passion - n. - [ˈpæʃ.ən] - пристрасть - B1
passport - n. - [ˈpæs.pɔːrt] - паспорт - A1
past - adj., n., prep. A1, adv. A2 - [pæst] - минулий, минуле - A1, A2
path - n. - [pæθ] - стежка - B1
patient - n. A2, adj. B2 - [ˈpeɪ.ʃənt] - пацієнт, терплячий - A2, B2
pattern - n. - [ˈpæt̬.ɚn] - візерунок - A2
pay - v. A1, n. A2 - [peɪ] - платити, заробітна плата - A1, A2
payment - n. - [ˈpeɪ.mənt] - оплата - B1
peace - n. - [piːs] - мир - A2
peaceful - adj. - [ˈpiːs.fəl] - мирний - B1
pen - n. - [pen] - ручка - A1
pencil - n. - [ˈpen.səl] - олівець - A1
penny - n. - [ˈpen.i] - пенні - A2
pension - n. - [ˈpen.ʃən] - пенсія - B2
people - n. - [ˈpiː.pəl] - люди - A1
pepper - n. - [ˈpep.ɚ] - перець - A1
per - prep. - [pɚ] - на, за, кожен - A2
per cent - n., adj./adv. A2 - [pər ˈsɛnt] - відсоток - A2
percentage - n. - [pərˈsɛn.t̬ɪdʒ] - відсоток - B1
perfect - adj. A1 - [ˈpɝː.fɪkt] - ідеальний - A1
perfectly - adv. - [ˈpɝː.fɪkt.li] - ідеально - B1
perform - v. A2 - [pərˈfɔːrm] - виконувати - A2
performance - n. - [pərˈfɔːr.məns] - виступ, виконання - B1
perhaps - adv. A2 - [pərˈhæps] - можливо, може бути - A2
period - n. - [ˈpɪr.i.əd] - період - A1
permanent - adj. B2 - [ˈpɝː.mə.nənt] - постійний - B2
permission - n. - [pərˈmɪʃ.ən] - дозвіл - A2
permit - v., n. - [pərˈmɪt] - дозволяти, дозвіл - B2
person - n. - [ˈpɜːr.sən] - особа - A1
personal - adj. - [ˈpɜːr.sən.əl] - особистий - A1
personality - n. - [ˌpɜːr.səˈnæl.ə.t̬i] - особистість - A2
personally - adv. - [ˈpɜːr.sən.əl.i] - особисто - B1
perspective - n. - [pərˈspek.tɪv] - перспектива - B2
persuade - v. - [pərˈsweɪd] - переконувати - B1
pet - n. - [pet] - домашній улюбленець - A2
petrol - n. - [ˈpet.rəl] - бензин - A2
phase - n. - [feɪz] - фаза - B2
phenomenon - n. - [fəˈnɑː.mɪn.ən] - явище - B2
philosophy - n. - [fɪˈlɑː.sə.fi] - філософія - B2
phone - n., v. - [foʊn] - телефон, телефонувати - A1
photo - n. - [ˈfoʊ.toʊ] - фото - A1
photograph - n. A1, v. A2 - [ˈfoʊ.t̬ə.ɡræf] - фотографія, фотографувати - A1, A2
photographer - n. - [fəˈtɑː.ɡrə.fɚ] - фотограф - B1
photography - n. - [fəˈtɑː.ɡrə.fi] - фотографія - B1
phrase - n. - [freɪz] - фраза - A1
physical - adj. - [ˈfɪzɪ.kəl] - фізичний - A2
physics - n. - [ˈfɪzɪks] - фізика - A2
piano - n. - [piˈænoʊ] - фортепіано - A1
pick - v. A2, n. B2 - [pɪk] - вибирати, вибір - A2, B2
picture - n. A1, v. B2 - [ˈpɪk.tʃɚ] - зображення, зображувати - A1, B2
piece - n. - [piːs] - шматок - A1
pig - n. - [pɪɡ] - свиня - A1
pile - n., v. B2 - [paɪl] - купа, накопичувати - B2
pilot - n. - [ˈpaɪ.lət] - пілот - A2
pin - n., v. B1 - [pɪn] - булавка, прикріпляти - B1
pink - adj., n. A1 - [pɪŋk] - рожевий, рожеве - A1
pipe - n. B1 - [paɪp] - труба - B1
pitch - n. B2 - [pɪtʃ] - тон, поле - B2
place - n. A1, v. B1 - [pleɪs] - місце, розміщати - A1, B1
plain - adj. B2 - [pleɪn] - рівнина, простий - B2
plan - n., v. A1 - [plæn] - план, планувати - A1
plane - n. A1 - [pleɪn] - літак - A1
planet - n. A2 - [ˈplæn.ɪt] - планета - A2
planning - n. B1 - [ˈplæn.ɪŋ] - планування - B1
plant - n. A1, v. A2 - [plænt] - рослина, саджати - A1, A2
plastic - n., adj. A2 - [ˈplæs.tɪk] - пластик, пластиковий - A2
plate - n. A2 - [pleɪt] - тарілка - A2
platform - n. A2 - [ˈplæt.fɔːrm] - платформа - A2
play - v., n. A1 - [pleɪ] - грати, гра - A1
player - n. A1 - [pleɪ.ər] - гравець - A1
pleasant - adj. B1 - [ˈplez.ənt] - приємний - B1
please - exclam. A1, v. A2 - [pliːz] - будь ласка, задовольняти - A1, A2
pleased - adj. A2 - [pliːzd] - задоволений - A2
pleasure - n. B1 - [ˈpleʒ.ɚ] - задоволення - B1
plenty - pron. B1 - [ˈplen.t̬i] - багато - B1
plot - n. B1, v. B2 - [plɑːt] - сюжет, змова - B1, B2
plus - prep. B1, adj., conj., n. B2 - [plʌs] - плюс, плюсовий - B1, B2
pocket - n. A2 - [ˈpɑː.kɪt] - кишеня - A2
poem - n. B1 - [poʊm] - вірш - B1
poet - n. B1 - [ˈpoʊ.ɪt] - поет - B1
poetry - n. B1 - [ˈpoʊ.ə.tri] - поезія - B1
point - n. A1, v. B1 - [pɔɪnt] - точка, вказувати - A1, B1
pointed - adj. B2 - [ˈpɔɪn.tɪd] - вказуючий - B2
poison - n., v. B1 - [ˈpɔɪ.zən] - отрута, отруювати - B1
poisonous - adj. B1 - [ˈpɔɪ.zən.əs] - отруйний - B1
police - n. A1 - [pəˈliːs] - поліція - A1
policeman - n. A1 - [ˈpɑː.ləs.mən] - поліцейський - A1
policy - n. B1 - [ˈpɑː.lə.si] - політика - B1
polite - adj. A2 - [pəˈlaɪt] - ввічливий - A2
political - adj. B1 - [pəˈlɪt.ɪ.kəl] - політичний - B1
politician - n. B1 - [ˌpɑː.ləˈtɪʃ.ən] - політик - B1
politics - n. B1 - [ˈpɑː.lə.tɪks] - політика - B1
pollution - n. A2 - [pəˈluː.ʃən] - забруднення - A2
pool - n. A1 - [puːl] - басейн - A1
poor - adj. A1 - [pʊr] - бідний - A1
pop - n., adj. A2 - [pɑːp] - поп, поповий - A2
popular - adj. A1 - [ˈpɑː.pjə.lɚ] - популярний - A1
popularity - n. B2 - [ˌpɑː.pjəˈlær.ə.t̬i] - популярність - B2
population - n. A2 - [ˌpɑː.pjəˈleɪ.ʃən] - населення - A2
port - n. B1 - [pɔːrt] - порт - B1
portrait - n. B1 - [ˈpɔːr.treɪt] - портрет - B1
pose - v. B2 - [poʊz] - позувати - B2
position - n. A2, v. B2 - [pəˈzɪʃ.ən] - положення, ставлення - A2, B2
positive - adj. A1, n. B2 - [ˈpɑː.zə.tɪv] - позитивний, позитив - A1, B2
possess - v. B2 - [pəˈzes] - володіти - B2
possession - n. A2 - [pəˈzeʃ.ən] - володіння - A2
possibility - n. A2 - [ˌpɑː.səˈbɪl.ə.t̬i] - можливість - A2
possible - adj. A1 - [ˈpɑː.sə.bəl] - можливий - A1
possibly - adv. B1 - [ˈpɑː.sə.bli] - можливо - B1
post - n., v. A1 - [poʊst] - пошта, відправляти - A1
poster - n. A2 - [ˈpoʊ.stɚ] - плакат - A2
pot - n. B1 - [pɑːt] - горщик - B1
potato - n. A1 - [pəˈteɪ.toʊ] - картопля - A1
potential - adj., n. B2 - [pəˈten.ʃəl] - потенційний, потенціал - B2
pound - n. A1 - [paʊnd] - фунт - A1
pour - v. B1 - [pɔːr] - наливати - B1
poverty - n. B1 - [ˈpɑː.vɚ.t̬i] - бідність - B1
powder - n. B1 - [ˈpaʊ.dɚ] - порошок - B1
power - n. A2, v. B2 - [ˈpaʊ.ɚ] - сила, здатність - A2, B2
powerful - adj. B1 - [ˈpaʊ.ɚ.fəl] - потужний - B1
practical - adj. B1 - [ˈpræk.tɪ.kəl] - практичний - B1
practice - n. A1 - [ˈpræk.tɪs] - практика - A1
practise - v. A1 - [ˈpræk.tɪs] - тренуватися - A1
praise - n., v. B2 - [preɪz] - хвала, хвалити - B2
pray - v. B1 - [preɪ] - молитися - B1
prayer - n. B1 - [prer] - молитва - B1
predict - v. A2 - [prɪˈdɪkt] - передбачати - A2
prediction - n. B1 - [prɪˈdɪk.ʃən] - передбачення - B1
prefer - v. A1 - [prɪˈfɝː] - віддавати перевагу - A1
pregnant - adj. B2 - [ˈpreɡ.nənt] - вагітна - B2
preparation - n. B2 - [ˌprep.əˈreɪ.ʃən] - підготовка - B2
prepare - v. A1 - [prɪˈper] - готувати - A1
prepared - adj. B1 - [prɪˈperd] - готовий - B1
presence - n. B2 - [ˈprez.əns] - присутність - B2
present - adj., n. A1, v. A2 - [ˈprez.ənt] - теперішній, подарунок, презентувати - A1, A2
presentation - n. B1 - [ˌprez.ənˈteɪ.ʃən] - презентація - B1
preserve - v. B2 - [prɪˈzɜːrv] - зберігати - B2
president - n. A2 - [ˈprez.ɪ.dənt] - президент - A2
press - v., n. B1 - [pres] - натискати, преса - B1
pressure - n. B1 - [ˈpreʃ.ɚ] - тиск - B1
pretend - v. B1 - [prɪˈtend] - робити вигляд, притворюватися - B1
pretty - adj., adv. A1 - [ˈprɪt̬.i] - гарний, досить - A1
prevent - v. A2 - [prɪˈvent] - запобігати - A2
previous - adj. B1 - [ˈpriː.vi.əs] - попередній - B1
previously - adv. B1 - [ˈpriː.vi.əs.li] - раніше - B1
price - n. A1, v. B2 - [praɪs] - ціна, вартість - A1, B2
priest - n. B1 - [priːst] - священик - B1
primary - adj. B1 - [ˈpraɪˌmer.i] - первинний - B1
prime - adj. B2 - [praɪm] - основний - B2
prince - n. B1 - [prɪns] - принц - B1
princess - n. B1 - [ˈprɪn.sɪs] - принцеса - B1
principle - n. B2 - [ˈprɪn.sə.pl̩] - принцип - B2
print - v. A2, n. B2 - [prɪnt] - друкувати, друк - A2, B2
printer - n. A2 - [ˈprɪnt.ɚ] - принтер - A2
printing - n. B1 - [ˈprɪn.tɪŋ] - друкування - B1
priority - n. B2 - [praɪˈɔːr.ə.t̬i] - пріоритет - B2
prison - n. A2 - [ˈprɪz.ən] - в'язниця - A2
prisoner - n. B1 - [ˈprɪz.ən.ɚ] - в'язень - B1
privacy - n. B2 - [ˈprɪv.ə.si] - конфіденційність - B2
private - adj. B1 - [ˈpraɪ.vət] - приватний - B1
prize - n. A2 - [praɪz] - приз - A2
probably - adv. A1 - [ˈprɑː.bə.bli] - можливо - A1
problem - n. A1 - [ˈprɑː.bl̩m] - проблема - A1
procedure - n. B2 - [prəˈsiː.dʒɚ] - процедура - B2
process - n. A2, v. B2 - [ˈprɑː.ses] - процес, обробляти - A2, B2
produce - v. A2, n. B2 - [prəˈduːs] - виробляти, продукція - A2, B2
producer - n. B1 - [prəˈduː.sɚ] - виробник - B1
product - n. A1 - [ˈprɑː.dʌkt] - продукт - A1
production - n. B1 - [prəˈdʌk.ʃən] - виробництво - B1
profession - n. B1 - [prəˈfeʃ.ən] - професія - B1
professional - adj. A2, n. B2 - [prəˈfeʃ.ən.əl] - професійний, професіонал - A2, B2
professor - n. A2 - [prəˈfes.ɚ] - професор - A2
profile - n. A2 - [ˈproʊ.faɪl] - профіль - A2
profit - n. B1 - [ˈprɑː.fɪt] - прибуток - B1
program - n. A2, v. B1 - [ˈproʊ.ɡræm] - програма, програмувати - A2, B1
programme - n. A1 - [ˈproʊ.ɡræm] - програма - A1
progress - n. A2, v. B2 - [ˈprɑː.ɡres] - прогрес, просуватися - A2, B2
project - n. A1, v. B2 - [ˈprɑː.dʒekt] - проект, проектувати - A1, B2
promise - v., n. A2 - [ˈprɑː.mɪs] - обіцяти, обіцянка - A2
promote - v. B1 - [prəˈmoʊt] - просувати, підтримувати - B1
pronounce - v. A2 - [prəˈnaʊns] - вимовляти - A2
proof - n. B2 - [pruːf] - доказ - B2
proper - adj. B1 - [ˈprɑː.pɚ] - правильний - B1
properly - adv. B1 - [ˈprɑː.pɚ.li] - належним чином - B1
property - n. B1 - [ˈprɑː.pɚ.t̬i] - власність - B1
proposal - n. B2 - [prəˈpoʊ.zəl] - пропозиція - B2
propose - v. B2 - [prəˈpoʊz] - пропонувати - B2
prospect - n. B2 - [ˈprɑː.spekt] - перспектива - B2
protect - v. A2 - [prəˈtekt] - захищати - A2
protection - n. B2 - [prəˈtek.ʃən] - захист - B2
protest - n., v. B1 - [ˈprəʊ.test] - протест, протестувати - B1
proud - adj. B1 - [praʊd] - гордий - B1
prove - v. B1 - [pruːv] - доводити - B1
provide - v. A2 - [prəˈvaɪd] - забезпечувати - A2
psychologist - n. B2 - [saɪˈkɑː.lə.dʒɪst] - психолог - B2
psychology - n. B2 - [saɪˈkɑː.lə.dʒi] - психологія - B2
pub - n. A2 - [pʌb] - паб - A2
public - adj., n. A2 - [ˈpʌb.lɪk] - громадський, громадяни - A2
publication - n. B2 - [ˌpʌblɪˈkeɪ.ʃən] - публікація - B2
publish - v. A2 - [ˈpʌb.lɪʃ] - публікувати - A2
pull - v. A2, n. B1 - [pʊl] - тягти, тягнення - A2, B1
punish - v. B1 - [ˈpʌn.ɪʃ] - покарати - B1
punishment - n. B1 - [ˈpʌn.ɪʃ.mənt] - покарання - B1
pupil - n. B2 - [ˈpjuː.pl̩] - учень - B2
purchase - n., v. B2 - [ˈpɝː.tʃəs] - купівля, купувати - B2
pure - adj. B2 - [pjʊr] - чистий - B2
purple - adj., n. A1 - [ˈpɝː.pl̩] - фіолетовий, фіолет - A1
purpose - n. A2 - [ˈpɝː.pəs] - мета - A2
pursue - v. B2 - [pərˈsuː] - домагатися, переслідувати - B2
push - v. A2, n. B1 - [pʊʃ] - тискати, тиск - A2, B1
put - v. A1 - [pʊt] - класти, ставити - A1
qualification - n. B1 - [ˌkwɑː.lɪ.fəˈkeɪ.ʃən] - кваліфікація - B1
qualified - adj. B1 - [ˈkwɑː.lɪ.faɪd] - кваліфікований - B1
qualify - v. B1 - [ˈkwɑː.lɪ.faɪ] - кваліфікувати - B1
quality - n. A2 - [ˈkwɑː.lə.t̬i] - якість - A2
quantity - n. A2 - [ˈkwɑːn.tə.t̬i] - кількість - A2
quarter - n. A1 - [ˈkwɔːr.t̬ɚ] - четверть - A1
queen - n. A2 - [kwiːn] - королева - A2
question - n. A1, v. A2 - [ˈkwes.tʃən] - питання, запитувати - A1, A2
queue - n., v. B1 - [kjuː] - черга, стояти в черзі - B1
quick - adj. A1 - [kwɪk] - швидкий - A1
quickly - adv. A1 - [ˈkwɪk.li] - швидко - A1
quiet - adj. A1 - [ˈkwaɪ.ət] - тихий - A1
quietly - adv. A2 - [ˈkwaɪ.ət.li] - тихо - A2
quit - v. B1 - [kwɪt] - припинити, покинути - B1
quite - adv. A1 - [kwaɪt] - досить - A1
quotation - n. B1 - [kwoʊˈteɪ.ʃən] - цитата - B1
quote - v., n. B1 - [kwoʊt] - цитувати, цитата - B1
race (competition) - n., v. A2 - [reɪs] - гонка, гонити - A2
race (people) - n. B1 - [reɪs] - раса - B1
racing - n. B1 - [ˈreɪ.sɪŋ] - гонки - B1
radio - n. A1 - [ˈreɪ.di.oʊ] - радіо - A1
railway - n. A2 - [ˈreɪl.weɪ] - залізниця - A2
rain - n., v. A1 - [reɪn] - дощ, йти дощем - A1
raise - v. A2 - [reɪz] - піднімати - A2
range - n. B1, v. B2 - [reɪndʒ] - діапазон, діапазонувати - B1, B2
rank - n., v. B2 - [ræŋk] - ранг, розташовувати за рангом - B2
rapid - adj. B2 - [ˈræp.ɪd] - швидкий - B2
rapidly - adv. B2 - [ˈræp.ɪd.li] - швидко - B2
rare - adj. B1 - [rer] - рідкісний - B1
rarely - adv. B1 - [ˈrer.li] - рідко - B1
rate - n. A2, v. B2 - [reɪt] - ставка, оцінка - A2, B2
rather - adv. A2 - [ˈræð.ɚ] - дещо, краще - A2
raw - adj. B2 - [rɔː] - сирий - B2
reach - v. A2, n. B2 - [riːtʃ] - досягати, досягнення - A2, B2
react - v. A2 - [riˈækt] - реагувати - A2
reaction - n. B1 - [riˈæk.ʃən] - реакція - B1
read - v. A1 - [riːd] - читати - A1
reader - n. A1 - [ˈriː.dɚ] - читач - A1
reading - n. A1 - [ˈriː.dɪŋ] - читання - A1
ready - adj. A1 - [ˈrɛ.di] - готовий - A1
real - adj. A1 - [riːl] - реальний - A1
realistic - adj. B2 - [ˌriː.əˈlɪs.tɪk] - реалістичний - B2
reality - n. B1 - [riˈæl.ə.t̬i] - реальність - B1
realize - v. A2 - [ˈriː.ə.laɪz] - усвідомити - A2
really - adv. A1 - [ˈriː.li] - дійсно - A1
reason - n. A1 - [ˈriː.zən] - причина - A1
reasonable - adj. B2 - [ˈriː.zən.ə.bəl] - розумний - B2
recall - v. B2 - [rɪˈkɔːl] - пригадувати - B2
receipt - n. B1 - [rɪˈsit] - квитанція - B1
receive - v. A2 - [rɪˈsiːv] - отримувати - A2
recent - adj. A2 - [ˈriː.sənt] - останній - A2
recently - adv. A2 - [ˈriː.sənt.li] - нещодавно - A2
reception - n. A2 - [rɪˈsep.ʃən] - прийом - A2
recipe - n. A2 - [ˈrɛs.ɪ.pi] - рецепт - A2
recognize - v. A2 - [ˈrek.əɡ.naɪz] - визнавати - A2
recommend - v. A2 - [ˌrek.əˈmend] - рекомендувати - A2
recommendation - n. B1 - [ˌrek.ə.menˈdeɪ.ʃən] - рекомендація - B1
record - n., v. A2 - [ˈrek.ɚd] - запис, записувати - A2
recording - n. A2 - [rɪˈkɔːr.dɪŋ] - запис - A2
recover - v. B2 - [rɪˈkʌv.ɚ] - одужувати - B2
recycle - v. A2 - [riːˈsaɪ.kəl] - переробляти - A2
red - adj., n. A1 - [red] - червоний, червонець - A1
reduce - v. A2 - [rɪˈduːs] - зменшувати - A2
reduction - n. B2 - [rɪˈdʌk.ʃən] - зменшення - B2
refer - v. A2 - [rɪˈfɝː] - посилатися, звертатися - A2
reference - n. B1 - [ˈref.ər.əns] - посилання - B1
reflect - v. B1 - [rɪˈflekt] - відображати, відбивати - B1
refuse1 - v. A2 - [rɪˈfjuːz] - відмовлятися - A2
regard - v., n. B2 - [rɪˈɡɑːrd] - стосуватися, увага - B2
region - n. A2 - [ˈriː.dʒən] - регіон - A2
regional - adj. B2 - [ˈriː.dʒən.əl] - регіональний - B2
register - v., n. B2 - [ˈredʒ.ɪ.stɚ] - реєструвати, реєстр - B2
regret - v., n. B2 - [rɪˈɡret] - шкодувати, сум - B2
regular - adj. A2 - [ˈreɡ.jə.lɚ] - регулярний - A2
regularly - adv. B1 - [ˈreɡ.jə.lɚ.li] - регулярно - B1
regulation - n. B2 - [ˌreɡ.jəˈleɪ.ʃən] - регулювання - B2
reject - v. B1 - [rɪˈdʒekt] - відхиляти - B1
relate - v. B1 - [rɪˈleɪt] - пов'язувати - B1
related - adj. B1 - [rɪˈleɪ.tɪd] - пов'язаний - B1
relation - n. B1 - [rɪˈleɪ.ʃən] - відносини - B1
relationship - n. A2 - [rɪˈleɪ.ʃən.ʃɪp] - стосунки - A2
relative - adj., n. B1 - [ˈrel.ə.tɪv] - відносний, родич - B1
relatively - adv. B2 - [ˈrel.ə.tɪv.li] - відносно - B2
relax - v. A1 - [rɪˈlæks] - розслаблятися - A1
relaxed - adj. B1 - [rɪˈlækst] - розслаблений - B1
relaxing - adj. B1 - [rɪˈlæk.sɪŋ] - релаксуючий - B1
release - v., n. B1 - [rɪˈliːs] - випускати, випуск - B1
relevant - adj. B2 - [ˈrel.ə.vənt] - важливий, актуальний - B2
reliable - adj. B1 - [rɪˈlaɪ.ə.bəl] - надійний - B1
relief - n. B2 - [rɪˈliːf] - полегшення - B2
religion - n. B1 - [rɪˈlɪdʒ.ən] - релігія - B1
religious - adj. B1 - [rɪˈlɪdʒ.əs] - релігійний - B1
rely - v. B2 - [rɪˈlaɪ] - покладатися - B2
remain - v. B1 - [rɪˈmeɪn] - залишатися - B1
remark - n., v. B2 - [rɪˈmɑːrk] - зауваження, зауважити - B2
remember - v. A1 - [rɪˈmem.bɚ] - пам'ятати - A1
remind - v. B1 - [rɪˈmaɪnd] - нагадувати - B1
remote - adj. B1 - [rɪˈmoʊt] - віддалений - B1
remove - v. A2 - [rɪˈmuːv] - видаляти - A2
rent - n., v. B1 - [rent] - оренда, орендувати - B1
repair - v. A2, n. B1 - [rɪˈper] - ремонтувати, ремонт - A2, B1
repeat - v. A1, n. B1 - [rɪˈpiːt] - повторювати, повтор - A1, B1
repeated - adj. B1 - [rɪˈpiː.tɪd] - повторний - B1
replace - v. A2 - [rɪˈpleɪs] - замінювати - A2
reply - v., n. A2 - [rɪˈplaɪ] - відповідати, відповідь - A2
report - n. A1, v. A2 - [rɪˈpɔːrt] - звіт, звітувати - A1, A2
reporter - n. A2 - [rɪˈpɔːrt.ɚ] - репортер - A2
represent - v. B1 - [ˌrɛprɪˈzɛnt] - представляти - B1
representative - n., adj. B2 - [ˌrɛprɪˈzɛntətɪv] - представник, представницький - B2
reputation - n. B2 - [ˌrɛpjəˈteɪʃən] - репутація - B2
request - n. A2, v. B1 - [rɪˈkwɛst] - запит, запитувати - A2, B1
require - v. B1 - [rɪˈkwaɪr] - потрібний, вимагати - B1
requirement - n. B2 - [rɪˈkwaɪr.mənt] - вимога - B2
rescue - v., n. B2 - [ˈrɛs.kjuː] - рятувати, порятунок - B2
research - n., v. A2 - [rɪˈsɜːrtʃ] - дослідження, досліджувати - A2
researcher - n. A2 - [rɪˈsɜːrtʃ.ɚ] - дослідник - A2
reservation - n. B1 - [ˌrɛz.ɚˈveɪ.ʃən] - резервація - B1
reserve - n., v. B2 - [rɪˈzɝːv] - резерв, резервувати - B2
resident - n., adj. B2 - [ˈrɛz.ɪ.dənt] - мешканець, місцевий - B2
resist - v. B2 - [rɪˈzɪst] - протистояти - B2
resolve - v. B2 - [rɪˈzɑːlv] - вирішувати - B2
resort - n. B2 - [rɪˈzɔːrt] - курорт - B2
resource - n. B1 - [rɪˈzɔːrs] - ресурс - B1
respect - n., v. B1 - [rɪˈspɛkt] - повага, поважати - B1
respond - v. A2 - [rɪˈspɑːnd] - реагувати - A2
response - n. A2 - [rɪˈspɑːns] - відповідь - A2
responsibility - n. B1 - [rɪˌspɑːnsəˈbɪləti] - відповідальність - B1
responsible - adj. B1 - [rɪˈspɑːnsəbl] - відповідальний - B1
rest (remaining part) n. A2 - [rɛst] - решта, залишок - A2
rest (sleep/relax) n., v. A2 - [rɛst] - відпочинок, відпочивати - A2
restaurant - n. A1 - [ˈrɛs.tə.rɑːnt] - ресторан - A1
result - n. A1, v. B1 - [rɪˈzʌlt] - результат, призводити до - A1, B1
retain - v. B2 - [rɪˈteɪn] - зберігати - B2
retire - v. B1 - [rɪˈtaɪr] - виходити на пенсію - B1
retired - adj. B1 - [rɪˈtaɪrd] - на пенсії - B1
return - v., n. A1 - [rɪˈtɝːn] - повертатися, повернення - A1
reveal - v. B2 - [rɪˈviːl] - розкривати - B2
review - n., v. A2 - [rɪˈvjuː] - огляд, переглядати - A2
revise - v. B1 - [rɪˈvaɪz] - переглядати - B1
revolution - n. B2 - [ˌrɛvəˈluːʃən] - революція - B2
reward - n., v. B2 - [rɪˈwɔːrd] - винагорода, винагороджувати - B2
rhythm - n. B2 - [ˈrɪð.əm] - ритм - B2
rice - n. A1 - [raɪs] - рис - A1
rich - adj. A1 - [rɪtʃ] - багатий - A1
rid - v. B2 - [rɪd] - позбавляти - B2
ride - v. A1, n. A2 - [raɪd] - їхати, поїздка - A1, A2
right - adj., adv., n. A1 - [raɪt] - правий, правильно, право - A1
ring1 - n. A2 - [rɪŋ] - кільце - A2
ring2 - v. A2, n. B1 - [rɪŋ] - дзвонити, дзвінок - A2, B1
rise - v. A2, n. B1 - [raɪz] - підніматися, підйом - A2, B1
risk - n., v. B1 - [rɪsk] - ризик, ризикувати - B1
river - n. A1 - [ˈrɪv.ɚ] - ріка - A1
road - n. A1 - [roʊd] - дорога - A1
robot - n. B1 - [ˈroʊ.bɑːt] - робот - B1
rock (stone) n. A2 - [rɑːk] - камінь - A2
rock (music) n. A2 - [rɑːk] - рок (музика) - A2
role - n. A2 - [roʊl] - роль - A2
roll - v., n. B1 - [roʊl] - котитися, рулон - B1
romantic - adj. B1 - [roʊˈmæn.tɪk] - романтичний - B1
roof - n. A2 - [ruːf] - дах - A2
room - n. A1 - [ruːm] - кімната - A1
root - n. B2 - [ruːt] - корінь - B2
rope - n. B1 - [roʊp] - мотузка - B1
rough - adj. B1 - [rʌf] - грубий - B1
round adj., adv., prep. A2, n. B2 - [raʊnd] - круглий, навколо, раунд - A2, B2
route - n. A2 - [ruːt] - маршрут - A2
routine - n. A1, adj. B2 - [ruːˈtiːn] - рутинний, рутина - A1, B2
row - n - [roʊ] - ряд - B1
royal - adj - [ˈrɔɪəl] - королівський - B1
rub - v - [rʌb] - терти - B2
rubber - n., adj - [ˈrʌbər] - гума, гумовий - B2
rubbish - n - [ˈrʌbɪʃ] - сміття - A2
rude - adj - [ruːd] - грубий - A2
rugby - n - [ˈrʌɡbi] - регбі - B1
rule - n - [ruːl], v - [ruːl] - правило, правити - A1, B1
run - v - [rʌn], n - [rʌn] - бігти, біг - A1, A2
runner - n - [ˈrʌnər] - бігун - A2
running - n - [ˈrʌnɪŋ] - біг - A2
rural - adj - [ˈrʊrəl] - сільський - B2
rush - v., n - [rʌʃ] - поспіх, торкатися - B2
sad - adj - [sæd] - сумний - A1
sadly - adv - [ˈsædli] - сумно - A2
safe - adj - [seɪf] - безпечний - A2
safety - n - [ˈseɪfti] - безпека - B1
sail - v - [seɪl], n - [seɪl] - вітрило, відправлятися в море - A2, B1
sailing - n - [ˈseɪlɪŋ] - мореплавство - A2
sailor - n - [ˈseɪlər] - моряк - B1
salad - n - [ˈsæləd] - салат - A1
salary - n - [ˈsæləri] - зарплата - A2
sale - n - [seɪl] - продаж - A2
salt - n - [sɔlt] - сіль - A1
same - adj., pron., adv. - [seɪm] - той же самий - A1
sample - n - [ˈsæmpəl], v - [ˈsæmpəl] - зразок, взяти зразок - B1, B2
sand - n - [sænd] - пісок - B1
sandwich - n - [ˈsændwɪtʃ] - сендвіч - A1
satellite - n - [ˈsætəlaɪt] - супутник - B2
satisfied - adj - [ˈsætɪsfaɪd] - задоволений - B2
satisfy - v - [ˈsætɪsfaɪ] - задовольняти - B2
Saturday - n - [ˈsætərdeɪ] - субота - A1
sauce - n - [sɔs] - соус - A2
save - v - [seɪv] - зберігати - A2
saving - n - [ˈseɪvɪŋ] - заощадження - B2
say - v - [seɪ] - говорити - A1
scale - n - [skeɪl] - масштаб - B2
scan - v - [skæn] - сканувати - B1
scared - adj - [skɛrd] - наляканий - A2
scary - adj - [ˈskɛri] - лякаючий - A2
scene - n - [siːn] - сцена, місце події - A2
schedule - n - [ˈʃɛdjuːl], v - [ˈʃɛdjuːl] - розклад, планувати - A2, B2
scheme - n - [skiːm] - схема, план - B2
school - n - [skuːl] - школа - A1
science - n - [ˈsaɪəns] - наука - A1
scientific - adj - [ˌsaɪənˈtɪfɪk] - науковий - B1
scientist - n - [ˈsaɪəntɪst] - вчений - A1
score - v., n - [skɔr] - набирати бали, рахунок - A2
scream - v., n - [skriːm] - кричати, крик - B2
screen - n - [skriːn], v - [skriːn] - екран, фільтрувати - A2, B2
script - n - [skrɪpt] - сценарій - B1
sculpture - n - [ˈskʌlptʃər] - скульптура - B1
sea - n - [siː] - море - A1
search - n - [sɜːrtʃ] - пошук - A2
season - n - [ˈsiːzən] - сезон - A2
seat - n - [siːt], v - [siːt] - сидіння, сідати - A2, B2
second1 (next after the first) - det./number - [ˈsɛkənd] - другий - A1, A2
second1 (unit of time) - n - [ˈsɛkənd] - секунда - A1
secondary - adj - [ˈsɛkənˌdɛri] - вторинний - B1
secondly - adv - [ˈsɛkəndli] - вдруге, по-друге - A2
secret - adj., n - [ˈsiːkrɪt] - секретний, таємниця - A2
secretary - n - [ˈsɛkrəˌtɛri] - секретар - A2
section - n - [ˈsɛkʃən] - секція - A1
sector - n - [ˈsɛktər] - сектор - B2
secure - v., adj. - [sɪˈkjʊr] - захищати, безпечний - B2
security - n. - [sɪˈkjʊrəti] - безпека - B1
see - v. - [si] - бачити - A1
seed - n. - [siːd] - насіння - B1
seek - v. - [siːk] - шукати - B2
seem - v. - [siːm] - здаватися - A2
select - v. - [sɪˈlɛkt] - обирати - B2
selection - n. - [sɪˈlɛkʃən] - вибір - B2
self - n. - [sɛlf] - сам, особа - B2
sell - v. - [sɛl] - продавати - A1
send - v. - [sɛnd] - відправляти - A1
senior - adj. - [ˈsinjər] - старший - B2
sense - n. - [sɛns], v. - [sɛns] - почуття, відчуття; розуміти - A2, B2
sensible - adj. - [ˈsɛnsəbl] - розумний - B1
sensitive - adj. - [ˈsɛnsɪtɪv] - чутливий - B2
sentence - n. - [ˈsɛntəns], v. - [ˈsɛntəns] - речення, засуджувати - A1, B2
separate - adj. - [ˈsɛpərɪt], v. - [ˈsɛpəreɪt] - окремий, відокремлювати - A2, B1
September - n. - [sɛpˈtɛmbər] - вересень - A1
sequence - n. - [ˈsikwəns] - послідовність - B2
series - n. - [ˈsɪriz] - серія - A2
serious - adj. - [ˈsɪriəs] - серйозний - A2
seriously - adv. - [ˈsɪriəsli] - серйозно - B1
servant - n. - слуга - B1
serve - v. - [sɜrv] - обслуговувати - A2
service - n. - [ˈsɜrvɪs] - послуга - A2
session - n. - [ˈsɛʃən] - сесія, засідання - B2
set (put) - v. - [sɛt] - ставити - B1
set (group) - n. - [sɛt] - набір, група - B1
setting - n. - [ˈsɛtɪŋ] - налаштування, оточення - B1
settle - v. - [ˈsɛtl̩] - вирішувати, оселятися - B2
seven - number - [ˈsɛvən] - сім - A1
seventeen - number - [ˌsɛvənˈtiːn] - сімнадцять - A1
seventy - number - [ˈsɛvənti] - сімдесят - A1
several - det./pron. - [ˈsɛvrəl] - кілька - A2
severe - adj. - [sɪˈvɪr] - суворий, важкий - B2
sex - n. - [sɛks] - стать - B1
sexual - adj. - [ˈsɛkʃuəl] - сексуальний - B1
shade - n. - [ʃeɪd] - відтінок, тінь - B2
shadow - n. - [ˈʃædoʊ] - тінь - B2
shake - v. - [ʃeɪk], n. - [ʃeɪk] - тремтіти, трусити; тремтіння - A2, B1
shall - modal v. - [ʃæl] - повинен - A2
shallow - adj. - [ˈʃæloʊ] - мілкий - B2
shame - n. - [ʃeɪm] - сором, жаль - B2
shape - n. - [ʃeɪp], v. - [ʃeɪp] - форма; формувати - A2, B2
share - v. - [ʃɛr], n. - [ʃɛr] - ділитися, частина - A1, B1
sharp - adj. - [ʃɑrp] - гострий - B1
she - pron. - [ʃi] - вона - A1
sheep - n. - [ʃiːp] - вівця - A1
sheet - n. - [ʃit] - лист - A2
shelf - n. - [ʃɛlf] - полиця - B1
shell - n. - [ʃɛl] - черепаха, оболонка - B1
shelter - n., v. - [ˈʃɛltər] - притулок; приховуватися - B2
shift - n. - [ʃɪft], v. - [ʃɪft] - зміна; зміщувати - B1, B2
shine - v. - [ʃaɪn] - сяяти - B1
shiny - adj. - [ˈʃaɪni] - блискучий - B1
ship - n. - [ʃɪp], v. - [ʃɪp] - корабель; відправляти - A2, B2
shirt - n. - [ʃɜrt] - сорочка - A1
shock - n., v. - [ʃɑk] - шок; шокувати - B2
shocked - adj. - [ʃɑkt] - шокований - B2
shoe - n. - [ʃu] - взуття - A1
shoot - v. - [ʃut] - стріляти - B1
shooting - n. - [ˈʃutɪŋ] - стрільба - B2
shop - n., v. - [ʃɑp] - магазин; купувати - A1
shopping - n. - [ˈʃɑpɪŋ] - шопінг, покупки - A1
short - adj. - [ʃɔrt] - короткий - A1
shot - n. - [ʃɑt] - постріл - B2
should - modal v. - [ʃʊd] - повинен - A1
shoulder - n. - [ˈʃoʊldər] - плече - A2
shout - v., n. - [ʃaʊt] - кричати; крик - A2
show - v., n. - [ʃoʊ] - показувати; шоу - A1
shower - n. - [ʃaʊər] - душ - A1
shut - v., adj. - [ʃʌt] - закривати; закритий - A2
shy - adj. - [ʃaɪ] - сором'язливий - B1
sick - adj. - [sɪk] - хворий - A1
side - n. - [saɪd] - бік - A2
sight - n. - [saɪt] - вид; пам'ятка - B1
sign - n., v. - [saɪn] - знак; підписувати - A2
signal - n., v. - [ˈsɪɡnl̩] - сигнал; сигналізувати - B1
significant - adj. - [sɪɡˈnɪfɪkənt] - значущий - B2
significantly - adv. - [sɪɡˈnɪfɪkəntli] - значуще - B2
silence - n. - [ˈsaɪləns] - тиша - B2
silent - adj. - [ˈsaɪlənt] - мовчазний - B1
silk - n. - [sɪlk] - шовк - B2
silly - adj. - [ˈsɪli] - дурний, дурниця - B1
silver - n., adj. - [ˈsɪlvər] - срібло; срібний - A2
similar - adj. - [ˈsɪmɪlər] - схожий - A1
similarity - n. - [ˌsɪmɪˈlærəti] - схожість - B1
similarly - adv. - [ˈsɪmɪlərli] - так само - B1
simple - adj. - [ˈsɪmpl̩] - простий - A2
simply - adv. - [ˈsɪmpli] - просто - B1
since - prep., conj. - [sɪns], adv. - [sɪns] - з того часу, оскільки; давно - A2, B1
sincere - adj. - [sɪnˈsɪr] - щирий - B2
sing - v. - [sɪŋ] - співати - A1
singer - n. - [ˈsɪŋər] - співак - A1
singing - n. - [ˈsɪŋɪŋ] - спів - A2
single - adj., n. - [ˈsɪŋɡəl] - один; одиничний - A2
sink - v. - [sɪŋk] - тонути - B1
sir - n. - [sɜr] - сир - A2
sister - n. - [ˈsɪstər] - сестра - A1
sit - v. - [sɪt] - сидіти - A1
site - n. - [saɪt] - місце, площа - A2
situation - n. - [ˌsɪtʃuˈeɪʃən] - ситуація - A1
six - number - [sɪks] - шість - A1
sixteen - number - [ˈsɪkstiːn] - шістнадцять - A1
sixty - number - [ˈsɪksti] - шістдесят - A1
size - n. - [saɪz] - розмір - A2
ski - v., n. - [ski] - кататися на лижах; лижі - A2
skiing - n. - [ˈskiɪŋ] - лижний спорт - A2
skill - n. - [skɪl] - навичка - A1
skin - n. - [skɪn] - шкіра - A2
skirt - n. - [skɜrt] - спідниця - A1
sky - n. - [skaɪ] - небо - A2
slave - n. - [sleɪv] - раб - B2
sleep - v. - [sliːp], n. - [sliːp] - спати; сон - A1, A2
slice - n., v. - [slaɪs] - шматок; нарізати - B1
slide - v., n. - [slaɪd] - ковзати; глибокий зріз - B2
slight - adj. - [slaɪt] - невеликий - B2
slightly - adv. - [ˈslaɪtli] - трошки - B1
slip - v. - [slɪp] - ковзати - B2
slope - n., v. - [sloʊp] - схил; нахилятися - B2
slow - adj. - [sloʊ] - повільний - A1, v. - [sloʊ] - повільно - B1
slowly - adv. - [ˈsloʊli] - повільно - A2
small - adj. - [smɔl] - малий - A1
smart - adj. - [smɑrt] - розумний, кмітливий - B1
smartphone - n. - [ˈsmɑrtfoʊn] - смартфон - A2
smell - v., n. - [smɛl] - пахнути; запах - A2
smile - v., n. - [smaɪl] - посмішка; посміхатися - A2
smoke - n., v. - [smoʊk] - дим; курити - A2
smoking - n. - [ˈsmoʊkɪŋ] - куріння - A2
smooth - adj. - [smuð] - гладкий - B1
snake - n. - [sneɪk] - змія - A1
snow - n., v. - [snoʊ] - сніг; снігопад - A1
so - adv., conj. - [soʊ] - так, отже; так що - A1
soap - n. - [soʊp] - мило - A2
soccer - n. - [ˈsɑkər] - футбол - A2
social - adj. - [ˈsoʊʃəl] - соціальний - A2
society - n. - [səˈsaɪəti] - суспільство - A2
sock - n. - [sɑk] - шкарпетка - A2
soft - adj. - [sɔft] - м'який - A2
software - n. - [ˈsɔftwɛr] - програмне забезпечення - B1
soil - n. - [sɔɪl] - ґрунт - B1
solar - adj. - [ˈsoʊlər] - сонячний - B2
soldier - n. - [ˈsoʊldʒər] - солдат - A2
solid - adj., n. - [ˈsɑlɪd] - твердий; твердий предмет - B1
solution - n. - [səˈluʃən] - рішення - A2
solve - v. - [sɑlv] - вирішувати - A2
some - det., pron. - [sʌm] - деякий, кілька - A1
somebody - pron. - [ˈsʌmbɑdi] - хтось - A1
someone - pron. - [ˈsʌmwʌn] - хто-небудь - A1
something - pron. - [ˈsʌmθɪŋ] - щось - A1
sometimes - adv. - [ˈsʌmˌtaɪmz] - іноді - A1
somewhat - adv. - [ˈsʌmˌwʌt] - трошки - B2
somewhere - adv., pron. - [ˈsʌmˌwɛr] - десь - A2
son - n. - [sʌn] - син - A1
song - n. - [sɔŋ] - пісня - A1
soon - adv. - [sun] - скоро - A1
sorry - adj., exclam. - [ˈsɑri] - вибачте; шкода - A1
sort - n. - [sɔrt], v. - [sɔrt] - вид; сортувати - A2, B1
soul - n. - [soʊl] - душа - B2
sound - n., v. - [saʊnd] - звук; звучати - A1
soup - n. - [suːp] - суп - A1
source - n. - [sɔrs] - джерело - A2
south - n., adj., adv. - [saʊθ] - південь; південний; на південь - A1
southern - adj. - [ˈsʌðərn] - південний - B1
space - n. - [speɪs] - простір - A1
speak - v. - [spik] - говорити - A1
speaker - n. - [ˈspikər] - спікер - A2
special - adj. - [ˈspɛʃəl] - спеціальний - A1
specialist - n., adj. - [ˈspɛʃəlɪst] - спеціаліст; спеціальний - B2
species - n. - [ˈspiʃiz] - вид - B2
specific - adj. - [spɪˈsɪfɪk] - конкретний - A2
specifically - adv. - [spɪˈsɪfɪkli] - конкретно - B1
speech - n. - [spiʧ] - мова; промова - A2
speed - n. - [spid] - швидкість - A2, v. - [spid] - рухатися швидко - B2
spell - v. - [spɛl] - читати (літерувати) - A1
spelling - n. - [ˈspɛlɪŋ] - правопис - A1
spend - v. - [spɛnd] - витрачати - A1
spending - n. - [ˈspɛndɪŋ] - витрати - B1
spicy - adj. - [ˈspaɪsi] - пікантний - B1
spider - n. - [ˈspaɪdər] - павук - A2
spirit - n. - [ˈspɪrɪt] - дух - B1
spiritual - adj. - [ˈspɪrɪtʃuəl] - духовний - B2
split - v., n. - [splɪt] - розщеплювати; розрив - B2
spoken - adj. - [ˈspoʊkən] - усно сказаний - B1
sponsor - v., n. - [ˈspɑnsər] - спонсорувати; спонсор - B2
spoon - n. - [spun] - ложка - A2
sport - n. - [spɔrt] - спорт - A1
spot - n. - [spɑt], v. - [spɑt] - пляма; помічати - B1, B2
spread - v. - [sprɛd], n. - [sprɛd] - розповсюджувати; розповсюдження - B1, B2
spring - n. - [sprɪŋ], v. - [sprɪŋ] - весна; стрибати - A1, B1
square - adj., n. - [skwɛr] - квадратний; квадрат - A2
stable - adj. - [ˈsteɪbl̩] - стійкий - B2
stadium - n. - [ˈsteɪdiəm] - стадіон - B1
staff - n. - [stæf] - персонал - B1
stage - n. - [steɪdʒ], v. - [steɪdʒ] - сцена; ставити - A2, B2
stair - n. - [stɛr] - сходи - A2
stamp - n. - [stæmp] - марка; печатка - A2
stand - v. - [stænd], n. - [stænd] - стояти; стенд - A1, B2
standard - n., adj. - [ˈstændərd] - стандарт; стандартний - B1
star - n. - [stɑr], v. - [stɑr] - зірка; блискати - A1, A2
stare - v. - [stɛr] - вперто дивитися - B2
start - v. - [stɑrt], n. - [stɑrt] - починати; початок - A1, A2
state - n. - [steɪt], adj., v. - [steɪt] - штат; становище; заявляти - A2, B1
statement - n. - [ˈsteɪtmənt] - заява - A1
station - n. - [ˈsteɪʃən] - станція - A1
statistic - n. - [stəˈtɪstɪk] - статистика - B1
statue - n. - [ˈstætʃu] - статуя - B1
status - n. - [ˈsteɪtəs] - статус - B2
stay - v. - [steɪ], n. - [steɪ] - залишатися; перебування - A1, A2
steady - adj. - [ˈstɛdi] - стійкий - B2
steal - v. - [stil] - красти - A2
steel - n. - [stil] - сталь - B2
steep - adj. - [stiːp] - крутий - B2
step - n. - [stɛp], v. - [stɛp] - крок; крокувати - A2, B2
stick (push into/attach) - v. - [stɪk] - торкатися (до чогось) - B1
stick (piece of wood) - n. - [stɪk] - палиця - B1
sticky - adj. - [ˈstɪki] - липкий - B2
stiff - adj. - [stɪf] - жорсткий - B2
still - adv. - [stɪl], adj. - [stɪl] - все ще; нерухомий - A1, B1
stock - n. - [stɑk] - запас, акції - B2
stomach - n. - [ˈstʌmək] - шлунок - A2
stone - n. - [stoʊn] - камінь - A2
stop - v., n. - [stɑp] - зупиняти; зупинка - A1
store - n. - [stɔr], v. - [stɔr] - магазин; зберігати - A2, B1
storm - n. - [stɔrm] - буря - A2
story - n. - [ˈstɔri] - історія, розповідь - A1
straight - adv., adj. - [streɪt] - прямо; прямий - A2
strange - adj. - [streɪndʒ] - дивний - A2
stranger - n. - [ˈstreɪndʒər] - незнайомець - B1
strategy - n. - [ˈstrætədʒi] - стратегія - A2
stream - n. - [strim] - потік - B2
street - n. - [strit] - вулиця - A1
strength - n. - [strɛŋkθ] - сила - B1
stress - n., v. - [strɛs] - стрес; наголошувати - A2
stretch - v., n. - [strɛtʃ] - розтягувати; протяг - B2
strict - adj. - [strɪkt] - суворий - B2
strike - v., n. - [straɪk] - удар; бути в стані - B2
string - n. - [strɪŋ] - струна - B1
strong - adj. - [strɔŋ] - сильний - A1
strongly - adv. - [ˈstrɔŋli] - сильно - B1
structure - n. - [ˈstrʌktʃər] - структура - A2, v. - [ˈstrʌktʃər] - будувати - B2
struggle - v., n. - [ˈstrʌɡəl] - боротися; боротьба - B2
student - n. - [ˈstudənt] - студент - A1
studio - n. - [ˈstjuːdioʊ] - студія - B1
study - n., v. - [ˈstʌdi] - навчання; вивчати - A1
stuff - n. - [stʌf], v. - [stʌf] - речі; наповнювати - B1, B2
stupid - adj. - [ˈstjuːpɪd] - дурний - A2
style - n. - [staɪl] - стиль - A1
subject - n. - [ˈsʌbdʒɪkt], adj. - [ˈsʌbdʒɪkt] - предмет; підданий - A1, B2
submit - v. - [səbˈmɪt] - подавати, відправляти - B2
substance - n. - [ˈsʌbstəns] - речовина - B1
succeed - v. - [səkˈsid] - досягати успіху - A2
success - n. - [səkˈsɛs] - успіх - A1
successful - adj. - [səkˈsɛsfəl] - успішний - A2
successfully - adv. - [səkˈsɛsfəli] - успішно - B1
such - det./pron. - [sʌtʃ] - такий - A2
sudden - adj. - [ˈsʌdn̩] - раптовий - B1
suddenly - adv. - [ˈsʌdənli] - раптом - A2
suffer - v. - [ˈsʌfər] - страждати - B1
sugar - n. - [ˈʃʊɡər] - цукор - A1
suggest - v. - [səˈdʒɛst] - запропонувати - A2
suggestion - n. - [səˈdʒɛstʃən] - пропозиція - A2
suit - n. - [sut], v. - [sut] - костюм; підходити - A2, B1
suitable - adj. - [ˈsutəbl̩] - відповідний - B1
sum - n., v. - [sʌm] - сума; підсумовувати - B2
summarize - v. - [ˈsʌməˌraɪz] - резюмувати - B1
summary - n. - [ˈsʌməri] - резюме - B1
summer - n. - [ˈsʌmər] - літо - A1
sun - n. - [sʌn] - сонце - A1
Sunday - n. - [ˈsʌndeɪ] - неділя - A1
supermarket - n. - [ˈsuːpərmɑrkɪt] - супермаркет - A1
supply - n., v. - [səˈplaɪ] - постачання; постачати - B1
support - v., n. - [səˈpɔrt] - підтримувати; підтримка - A2
supporter - n. - [səˈpɔrtər] - прихильник - B1
suppose - v. - [səˈpoʊz] - припускати - A2
sure - adj. - [ʃʊr] - впевнений - A1
surely - adv. - [ˈʃʊrli] - безперечно - B1
surface - n. - [ˈsɜrfɪs] - поверхня - B1
surgery - n. - [ˈsɜrdʒəri] - хірургія - B2
surprise - n., v. - [səˈpraɪz] - сюрприз; дивувати - A2
surprised - adj. - [səˈpraɪzd] - здивований - A2
surprising - adj. - [səˈpraɪzɪŋ] - дивовижний - A2
surround - v. - [səˈraʊnd] - оточувати - B2
surrounding - adj. - [səˈraʊndɪŋ] - навколишній - B2
survey - n. - [ˈsɜrveɪ], v. - [sərˈveɪ] - опитування; проводити опитування - A2, B2
survive - v. - [sərˈvaɪv] - виживати - B1
suspect - v., n. - [səˈspɛkt] - підозрювати; підозрюваний - B2
swear - v. - [swɛr] - клятися - B2
sweater - n. - [ˈswɛtər] - светр - A1
sweep - v. - [swip] - мести - B2
sweet - adj., n. - [swiːt] - солодкий; солодощі - A2
swim - v. - [swɪm] - плавати - A1
swimming - n. - [ˈswɪmɪŋ] - плавання - A1
switch - v. - [swɪʧ], n. - [swɪʧ] - перемикач; перемикати - B1, B2
symbol - n. - [ˈsɪmbəl] - символ - A2
sympathy - n. - [ˈsɪmpəθi] - співчуття - B2
symptom - n. - [ˈsɪmptəm] - симптом - B1
system - n. - [ˈsɪstəm] - система - A2
table - n. - [ˈteɪbl̩] - стіл - A1
tablet - n. - [ˈtæblɪt] - планшет - A2
tail - n. - [teɪl] - хвіст - B1
take - v. - [teɪk] - приймати - A1
tale - n. - [teɪl] - оповідання, казка - B2
talent - n. - [ˈtælənt] - талант - B1
talented - adj. - [ˈtæləntɪd] - талановитий - B1
talk - v. - [tɔk], n. - [tɔk] - розмовляти; розмова - A1, A2
tall - adj. - [tɔl] - високий - A1
tank - n. - [tæŋk] - бак, резервуар - B2
tape - n. - [teɪp] - стрічка, тейп - B1
target - n. - [ˈtɑrɡɪt], v. - [ˈtɑrɡɪt] - ціль; визначати ціль - A2, B2
task - n. - [tæsk] - завдання - A2
taste - n., v. - [teɪst] - смак; смакувати - A2
tax - n., v. - [tæks] - податок; обкладати податком - B1
taxi - n. - [ˈtæksi] - таксі - A1
tea - n. - [ti] - чай - A1
teach - v. - [titʃ] - вчити - A1
teacher - n. - [ˈtitʃər] - вчитель - A1
teaching - n. - [ˈtitʃɪŋ] - навчання - A2
team - n. - [tim] - команда - A1
tear1 - v., n. - [tɪr] - рвати; сльоза - B2
tear2 - n. - [tɛr] - подертя - B2
technical - adj. - [ˈtɛknɪkəl] - технічний - B1
technique - n. - [tɛkˈnik] - техніка, методика - B1
technology - n. - [tɛkˈnɑlədʒi] - технологія - A2
teenage - adj. - [ˈtinˌeɪdʒ] - підлітковий - A2
teenager - n. - [ˈtinˌeɪdʒər] - підліток - A1
telephone - n., v. - [ˈtɛləˌfoʊn] - телефон; телефонувати - A1
television - n. - [ˈtɛlɪˌvɪʒən] - телевізор - A1
tell - v. - [tɛl] - розповідати - A1
temperature - n. - [ˈtɛmpərətjʊr] - температура - A2
temporary - adj. - [ˈtɛmpəˌrɛri] - тимчасовий - B2
ten - number - [tɛn] - десять - A1
tend - v. - [tɛnd] - мати тенденцію - B1
tennis - n. - [ˈtɛnɪs] - теніс - A1
tent - n. - [tɛnt] - намет - B1
term - n. - [tɜrm], v. - [tɜrm] - термін; визначати термін - A2, B2
terrible - adj. - [ˈtɛrəbl̩] - жахливий - A1
test - n., v. - [tɛst] - тест; тестувати - A1
text - n. - [tɛkst], v. - [tɛkst] - текст; писати текст - A1, A2
than - conj. - [ðæn] - ніж - A1
thank - v. - [θæŋk] - дякувати - A1
thanks - exclam., n. - [θæŋks] - дякувати; подяка - A1
that - det., pron., conj. - [ðæt], adv. - [ðət] - той, що; тому, що - A1, B1
the - definite article - [ði] - стаття визначена - A1
theatre - n. - [ˈθiətər] - театр - A1
their - det. - [ðɛr] - їхній - A1
theirs - pron. - [ðɛrz] - їхній - B1
them - pron. - [ðɛm] - їх, їхніх - A1
theme - n. - [θim] - тема - B1
themselves - pron. - [ðɛmˈsɛlvz] - себе, сами - A2
then - adv. - [ðɛn] - тоді - A1
theory - n. - [ˈθiəri] - теорія - B1
therapy - n. - [ˈθɛrəpi] - терапія - B2
there - adv. - [ðɛr] - там - A1
therefore - adv. - [ˌðɛrˈfɔr] - отже - B1
they - pron. - [ðeɪ] - вони - A1
thick - adj. - [θɪk] - товстий - A2
thief - n. - [θif] - злодій - A2
thin - adj. - [θɪn] - тонкий - A2
thing - n. - [θɪŋ] - річ - A1
think - v. - [θɪŋk] - думати - A1
thinking - n. - [ˈθɪŋkɪŋ] - мислення - A2
third - number - [θɜrd] - третій - A1, A2
thirsty - adj. - [ˈθɜrsti] - спраглий - A1
thirteen - number - [ˈθɜrtin] - тринадцять - A1
thirty - number - [ˈθɜrti] - тридцять - A1
this - det./pron. - [ðɪs], adv. - [ðɪs] - цей; так - A1, B1
though - conj., adv. - [ðoʊ] - хоча; все-таки - B1
thought - n. - [θɔt] - думка - A2
thousand - number - [ˈθaʊzənd] - тисяча - A1
threat - n. - [θrɛt] - загроза - B2
threaten - v. - [ˈθrɛtən] - загрожувати - B2
three - number - [θri] - три - A1
throat - n. - [θroʊt] - горло - B1
through - prep., adv. - [θru] - через; крізь - A1
throughout - prep./adv. - [θruːˈaʊt] - повсюди; на протязі - B1
throw - v. - [θroʊ] - кидати - A2
Thursday - n. - [ˈθɜrzdeɪ] - четвер - A1
thus - adv. - [ðʌs] - отже - B2
ticket - n. - [ˈtɪkɪt] - квиток - A1
tidy - adj., v. - [ˈtaɪdi] - охайний; прибирати - A2
tie - v., n. - [taɪ] - зав'язувати; кравата - A2
tight - adj. - [taɪt] - тісний - B1
till - conj./prep. - [tɪl] - доки; до - B1
time - n. - [taɪm], v. - [taɪm] - час; витрачати час - A1, B2
tin - n. - [tɪn] - бляшанка - B1
tiny - adj. - [ˈtaɪni] - крихітний - B1
tip - n. - [tɪp], v. - [tɪp] - верхівка; давати чайові - A2, B1
tired - adj. - [taɪrd] - втомлений - A1
title - n. - [ˈtaɪtl̩], v. - [ˈtaɪtl̩] - назва; давати назву - A1, B2
to - prep., infinitive marker - [tu] - до; для - A1
today - adv., n. - [təˈdeɪ] - сьогодні - A1
toe - n. - [toʊ] - палець на нозі - B1
together - adv. - [təˈɡɛðər] - разом - A1
toilet - n. - [ˈtɔɪlɪt] - туалет - A1
tomato - n. - [təˈmeɪtoʊ] - томат - A1
tomorrow - adv., n. - [təˈmɑroʊ] - завтра - A1
tone - n. - [toʊn] - тон - B2
tongue - n. - [tʌŋ] - язик - B1
tonight - adv., n. - [təˈnaɪt] - сьогодні ввечері - A1
too - adv. - [tu] - теж, також - A1
tool - n. - [tuːl] - інструмент - A2
tooth - n. - [tuθ] - зуб - A1
top - n., adj. - [tɑp] - верх; верхній - A2
topic - n. - [ˈtɑpɪk] - тема - A1
total - adj., n. - [ˈtoʊtl̩] - загальний; сума - B1
totally - adv. - [ˈtoʊtəli] - повністю - B1
touch - v. - [tʌʧ], n. - [tʌʧ] - торкатися; дотик - A2, B1
tough - adj. - [tʌf] - важкий, трудний - B2
tour - n. - [tʊr], v. - [tʊr] - тур; подорожувати - A2, B1
tourism - n. - [ˈtʊrɪzəm] - туризм - A2
tourist - n. - [ˈtʊrɪst] - турист - A1
towards - prep. - [təˈwɔrdz] - до, в напрямку - A2
towel - n. - [taʊəl] - рушник - A2
tower - n. - [ˈtaʊər] - вежа - A2
town - n. - [taʊn] - місто - A1
toy - n., adj. - [tɔɪ] - іграшка; іграшковий - A2
track - n. - [træk], v. - [træk] - трек; слідити - A2, B2
trade - n., v. - [treɪd] - торгівля; торгувати - B1
tradition - n. - [trəˈdɪʃən] - традиція - A2
traditional - adj. - [trəˈdɪʃənl̩] - традиційний - A2
traffic - n. - [ˈtræfɪk] - рух; транспортний потік - A1
train - n. - [treɪn], v. - [treɪn] - поїзд; навчати - A1, A2
trainer - n. - [ˈtreɪnər] - тренер - A2
training - n. - [ˈtreɪnɪŋ] - навчання - A2
transfer - v., n. - [trænsˈfɜr] - переносити; перенесення - B2
transform - v. - [trænsˈfɔrm] - трансформувати - B2
transition - n. - [trænˈzɪʃən] - перехід - B2
translate - v. - [trænsˈleɪt] - перекладати - B1
translation - n. - [trænsˈleɪʃən] - переклад - B1
transport - n., v. - [ˈtrænspɔrt] - транспорт; транспортувати - A2, B1
travel - v., n. - [ˈtrævəl] - подорожувати; подорож - A1
traveller - n. - [ˈtrævələr] - подорожуючий - A2
treat - v. - [triːt] - лікувати; ласувати - B1
treatment - n. - [ˈtriːtmənt] - лікування - B1
tree - n. - [tri] - дерево - A1
trend - n. - [trɛnd] - тенденція - B1
trial - n. - [ˈtraɪəl] - випробування - B2
trick - n., v. - [trɪk] - трюк; жарт - B1
trip - n. - [trɪp], v. - [trɪp] - подорож; спотворювати - A1, B2
tropical - adj. - [ˈtrɑpɪkl̩] - тропічний - B2
trouble - n. - [ˈtrʌbl̩], v. - [ˈtrʌbl̩] - проблема; турбувати - A2, B2
trousers - n. - [ˈtraʊzərz] - штани - A1
truck - n. - [trʌk] - вантажівка - A2
true - adj. - [truː] - справжній - A1
truly - adv. - [ˈtruːli] - дійсно - B2
trust - n., v. - [trʌst] - довіра; довіряти - B2
truth - n. - [truːθ] - правда - B1
try - v. - [traɪ], n. - [traɪ] - намагатися; спроба - A1, B2
T-shirt - n. - [ˈtiˌʃɜrt] - футболка - A1
tube - n. - [tub] - труба; метро - B1
Tuesday - n. - [ˈtuzdeɪ] - вівторок - A1
tune - n. - [tun] - мелодія - B2
tunnel - n. - [ˈtʌnl̩] - тунель - B2
turn - v., n. - [tɜrn] - обертати; оберт - A1
TV - n. - [ˌtiːˈviː] - телебачення - A1
twelve - number - [twɛlv] - дванадцять - A1
twenty - number - [ˈtwɛnti] - двадцять - A1
twice - adv. - [twaɪs] - двічі - A1
twin - n., adj. - [twɪn] - близнюк; подвійний - A2
two - number - [tu] - два - A1
type - n. - [taɪp], v. - [taɪp] - тип; класифікувати - A1, B1
typical - adj. - [ˈtɪpɪkl̩] - типовий - A2
typically - adv. - [ˈtɪpɪkli] - типово - B1
tyre - n. - [taɪər] - шина - B1
ugly - adj. - [ˈʌɡli] - потворний - B1
ultimately - adv. - [ˈʌltɪmətli] - в кінцевому підсумку - B2
umbrella - n. - [ʌmˈbrɛlə] - парасолька - A1
unable - adj. - [ʌnˈeɪbl̩] - неспроможний - B1
uncle - n. - [ˈʌŋkəl] - дядько - A1
uncomfortable - adj. - [ˌʌnˈkʌmfərtəbl̩] - незручний - B1
unconscious - adj. - [ʌnˈkɑnʃəs] - без свідомості - B2
under - prep., adv. - [ˈʌndər] - під; нижче - A1
underground - adj., adv. - [ˈʌndərˌɡraʊnd] - підземний; підземно - A2
understand - v. - [ˌʌndərˈstænd] - розуміти - A1
understanding - n. - [ˌʌndərˈstændɪŋ] - розуміння - A2
underwear - n. - [ˈʌndərˌwɛr] - білизна - B1
unemployed - adj. - [ˌʌnɪmˈplɔɪd] - безробітний - B1
unemployment - n. - [ˌʌnɪmˈplɔɪmənt] - безробіття - B1
unexpected - adj. - [ˌʌnɪkˈspɛktɪd] - неочікуваний - B2
unfair - adj. - [ʌnˈfɛr] - несправедливий - B1
unfortunately - adv. - [ʌnˈfɔrtʃənətli] - на жаль - A2
unhappy - adj. - [ʌnˈhæpi] - нещасливий - A2
uniform - n. - [ˈjunəˌfɔrm] - форма - A2
union - n. - [ˈjunjən] - союз - B1
unique - adj. - [juˈnik] - унікальний - B2
unit - n. - [ˈjunɪt] - одиниця - A2
united - adj. - [juˈnaɪtɪd] - об'єднаний - A2
universe - n. - [ˈjunɪˌvɜrs] - всесвіт - B2
university - n. - [ˌjuːnɪˈvɜrsəti] - університет - A1
unknown - adj. - [ˌʌnˈnoʊn] - невідомий - B2
unless - conj. - [ʌnˈlɛs] - якщо не - B1
unlike - prep. - [ʌnˈlaɪk] - неподібно до - B1
unlikely - adj. - [ˌʌnˈlaɪkli] - малоймовірний - B1
unnecessary - adj. - [ʌnˈnɛsəsəri] - непотрібний - B1
unpleasant - adj. - [ʌnˈplɛzənt] - неприємний - B1
until - conj./prep. - [ʌnˈtɪl] - до - A1
unusual - adj. - [ʌnˈjuʒuəl] - незвичайний - A2
up - adv., prep. - [ʌp] - вгору; вище - A1
update - v., n. - [ʌpˈdeɪt] - оновлювати; оновлення - B1
upon - prep. - [əˈpɒn] - на - B1
upper - adj. - [ˈʌpər] - верхній - B2
upset - adj., v. - [ʌpˈsɛt] - засмучений; викидати з рівноваги - B1
upstairs - adv. - [ˌʌpˈstɛrz], adj. - [ˌʌpˈstɛrz] - нагорі; верхній поверх - A1, A2
upwards - adv. - [ˈʌpwərdz] - вгору - B2
urban - adj. - [ˈɜrbən] - міський - B2
urge - v. - [ɜrdʒ] - підштовхувати - B2
us - pron. - [ʌs] - нас - A1
use - v. - [jus], n. - [jus] - використовувати; використання - A1, A2
used1 - adj. - [juzd] - звичний, вживаний - B1
used2 - adj. - [juzd] - вживаний - B1
used to - modal v. - [juzd tu] - звикати, мав звичай - A2
useful - adj. - [ˈjusfəl] - корисний - A1
user - n. - [ˈjuzər] - користувач - A2
usual - adj. - [ˈjuzjuəl] - звичайний - A2
usually - adv. - [ˈjuzjuəli] - зазвичай - A1
vacation - n. - [veɪˈkeɪʒən] - відпустка - A1
valley - n. - [ˈvæli] - долина - A2
valuable - adj. - [ˈvæljuəbl̩] - цінний - B1
value - n. - [ˈvælju] - цінність; цінити - B1, B2
van - n. - [væn] - фургон - A2
variety - n. - [vəˈraɪəti] - різноманітність - A2
various - adj. - [ˈvɛriəs] - різний - B1
vary - v. - [ˈvɛri] - відрізнятися - B2
vast - adj. - [væst] - величезний - B2
vegetable - n. - [ˈvɛdʒtəbl̩] - овоч - A1
vehicle - n. - [ˈviɪkəl] - транспортний засіб - A2
venue - n. - [ˈvɛnjuː] - місце проведення - B2
version - n. - [ˈvɜrʒən] - версія - B1
very - adv. - [ˈvɛri], adj. - [ˈvɛri] - дуже - A1, B2
via - prep. - [ˈvaɪə] - через - B2
victim - n. - [ˈvɪktɪm] - жертва - B1
victory - n. - [ˈvɪktəri] - перемога - B2
video - n. - [ˈvɪdioʊ] - відео - A1
view - n. - [vjuː], v. - [vjuː] - вид; розглядати - A2, B1
viewer - n. - [ˈvjuːər] - глядач - B1
village - n. - [ˈvɪlɪdʒ] - село - A1
violence - n. - [ˈvaɪələns] - насильство - B2
violent - adj. - [ˈvaɪələnt] - насильницький - B1
virtual - adj. - [ˈvɜrtʃuəl] - віртуальний - B2
virus - n. - [ˈvaɪrəs] - вірус - A2
vision - n. - [ˈvɪʒən] - бачення - B2
visit - v., n. - [ˈvɪzɪt] - відвідувати; візит - A1
visitor - n. - [ˈvɪzɪtər] - відвідувач - A1
visual - adj. - [ˈvɪʒuəl] - візуальний - B2
vital - adj. - [ˈvaɪtl̩] - життєво важливий - B2
vitamin - n. - [ˈvɪtəmɪn] - вітамін - B2
voice - n. - [vɔɪs] - голос - A2
volume - n. - [ˈvɑl.jum] - об'єм; гучність - B2
volunteer - n., v. - [ˌvɒl.ənˈtɪr] - волонтер; волонтерити - B1
vote - n., v. - [voʊt] - голосування; голосувати - B1
wage - n. - [weɪdʒ] - зарплата - B2
wait - v. - [weɪt], n. - [weɪt] - чекати; очікування - A1, A2
waiter - n. - [ˈweɪ.t̬ər] - офіціант - A1
wake - v. - [weɪk] - прокидатися - A1
walk - v., n. - [wɑk] - гуляти; прогулянка - A1
wall - n. - [wɑl] - стіна - A1
want - v. - [wɑnt] - хотіти - A1
war - n. - [wɔr] - війна - A2
warm - adj. - [wɔrm], v. - [wɔrm] - теплий; нагрівати - A1, B1
warn - v. - [wɔrn] - попереджати - B1
warning - n. - [ˈwɔrnɪŋ] - попередження - B1
wash - v. - [wɑʃ], n. - [wɑʃ] - мити; прання - A1, A2
washing - n. - [ˈwɑʃɪŋ] - прання - A2
waste - n., v., adj. - [weɪst] - відходи; витрачати; марнувати - B1
watch - v., n. - [wɑtʃ] - дивитися; годинник - A1
water - n. - [ˈwɔtər], v. - [ˈwɔtər] - вода; поливати - A1, B1
wave - n. - [weɪv], v. - [weɪv] - хвиля; махати - A2, B1
way - n. - [weɪ], adv. - [weɪ] - шлях; спосіб - A1, B2
we - pron. - [wiː] - ми - A1
weak - adj. - [wik] - слабкий - A2
weakness - n. - [ˈwiknɪs] - слабкість - B2
wealth - n. - [wɛlθ] - багатство - B2
wealthy - adj. - [ˈwɛlθi] - багатий - B2
weapon - n. - [ˈwɛpən] - зброя - B1
wear - v. - [wɛr] - носити (одяг); зношуватися - A1
weather - n. - [ˈwɛðər] - погода - A1
web - n. - [wɛb] - павутиння; веб-сайт - A2
website - n. - [ˈwɛbsaɪt] - веб-сайт - A1
wedding - n. - [ˈwɛdɪŋ] - весілля - A2
Wednesday - n. - [ˈwɛnzdeɪ] - середа - A1
week - n. - [wiːk] - тиждень - A1
weekend - n. - [ˈwiːˌkɛnd] - вихідні - A1
weigh - v. - [weɪ] - важити - B1
weight - n. - [weɪt] - вага - A2
welcome - exclam., v., adj. - [ˈwɛlkəm], n. - [ˈwɛlkəm] - ласкаво просимо; вітаємо; вітання - A1, A2
well - adv., adj., exclam. - [wɛl] - добре; здорово - A1
west - n., adj., adv. - [wɛst] - захід; західний; на захід - A1
western - adj. - [ˈwɛstərn] - західний - B1
wet - adj. - [wɛt] - мокрий - A2
what - pron./det. - [wʌt] - що - A1
whatever - det./pron. - [wʌtˈɛvər] - що б - B1
wheel - n. - [wiːl] - колесо - A2
when - adv., pron., conj. - [wɛn] - коли - A1
whenever - conj. - [wɛnˈɛvər] - коли б - B1
where - adv., conj. - [wɛr] - де - A1
whereas - conj. - [wɛrˈæz] - в той час як - B2
wherever - conj. - [wɛrˈɛvər] - де б - B2
whether - conj. - [ˈwɛðər] - чи - B1
which - pron./det. - [wɪtʃ] - який - A1
while - conj. - [waɪl], n. - [waɪl] - поки; час - A2, B1
whisper - v., n. - [ˈwɪspər] - шепотіти; шепіт - B2
white - adj., n. - [waɪt] - білий - A1
who - pron. - [huː] - хто - A1
whole - adj. - [hoʊl], n. - [hoʊl] - цілий; цілісний - A2, B1
whom - pron. - [huːm] - кого; кому - B2
whose - det./pron. - [huːz] - чий - A2
why - adv. - [waɪ] - чому - A1
wide - adj. - [waɪd] - широкий - A2
widely - adv. - [ˈwaɪdli] - широко - B2
wife - n. - [waɪf] - дружина - A1
wild - adj. - [waɪld] - дикий - A2
wildlife - n. - [ˈwaɪld.laɪf] - дика природа - B2
will - modal v. - [wɪl], n. - [wɪl] - будувати; воля - A1, B1
willing - adj. - [ˈwɪlɪŋ] - готовий - B2
win - v. - [wɪn], n. - [wɪn] - вигравати; перемога - A1, B1
wind1 - n. - [wɪnd] - вітер - A2
wind2 - v. - [waɪnd] - завивати - B2
window - n. - [ˈwɪndoʊ] - вікно - A1
wine - n. - [waɪn] - вино - A1
wing - n. - [wɪŋ] - крило - B1
winner - n. - [ˈwɪnər] - переможець - A2
winter - n. - [ˈwɪntər] - зима - A1
wire - n. - [waɪər] - дріт - B2
wise - adj. - [waɪz] - мудрий - B2
wish - v., n. - [wɪʃ] - бажати; бажання - A2
with - prep. - [wɪð] - з, разом із - A1
within - prep. - [wɪˈðɪn] - всередині - B1
without - prep. - [wɪˈðaʊt] - без - A1
witness - n., v. - [ˈwɪtnəs] - свідок; бути свідком - B2
woman - n. - [ˈwʊmən] - жінка - A1
wonder - v., n. - [ˈwʌndər] - дивуватися; диво - B1
wonderful - adj. - [ˈwʌndərfəl] - чудовий - A1
wood - n. - [wʊd] - дерево - A2
wooden - adj. - [ˈwʊdən] - дерев'яний - A2
wool - n. - [wʊl] - вовна - B1
word - n. - [wɜrd] - слово - A1
work - v., n. - [wɜrk] - працювати; робота - A1
worker - n. - [ˈwɜrkər] - робітник - A1
working - adj. - [ˈwɜrkɪŋ] - працюючий - A2
world - n. - [wɜrld] - світ - A1
worldwide - adj., adv. - [ˈwɜrldˈwaɪd] - по всьому світу - B1
worried - adj. - [ˈwɜrɪd] - занепокоєний - A2
worry - v., n. - [ˈwɜri] - турбуватися; турбота - A2, B1
worse - adj. - [wɜrs], adv. - [wɜrs], n. - [wɜrs] - гірший - A2, B1, B2
worst - adj. - [wɜrst], adv. - [wɜrst], n. - [wɜrst] - найгірший - A2, B1, B2
worth - adj. - [wɜrθ], n. - [wɜrθ] - вартий; вартість - B1, B2
would - modal v. - [wʊd] - би - A1
wound - n., v. - [wuːnd] - поранення; поранити - B2
wow - exclam. - [waʊ] - вау - A2
wrap - v. - [ræp] - завивати - B2
write - v. - [raɪt] - писати - A1
writer - n. - [ˈraɪtər] - письменник - A1
writing - n. - [ˈraɪtɪŋ] - письмо - A1
written - adj. - [ˈrɪtn̩] - написаний - B1
wrong - adj. - [rɔŋ], adv. - [rɔŋ], n. - [rɔŋ] - неправильний; неправильно; помилка - A1, B1, B2
yard - n. - [jɑrd] - двір - B1
yeah - exclam. - [jɛ] - так - A1
year - n. - [jɪr] - рік - A1
yellow - adj., n. - [ˈjɛloʊ] - жовтий - A1
yes - exclam. - [jɛs] - так - A1
yesterday - adv., n. - [ˈjɛstərdeɪ] - вчора - A1
yet - adv. - [jɛt], conj. - [jɛt] - ще; але - A2, B2
you - pron. - [ju] - ти, ви - A1
young - adj. - [jʌŋ] - молодий - A1
your - det. - [jʊər] - твій, ваш - A1
yours - pron. - [jʊərz] - твій, ваш - A2
yourself - pron. - [jʊrˈsɛlf] - себе - A1
youth - n. - [juθ] - молодь - B1
zero - number - [ˈzɪroʊ] - нуль - A2
zone - n. - [zoʊn] - зона - B2